Object ID,ZCTA5,modzcta,Geographic Identifier - FIPS Code,Area of Land (Square Meters),Area of Water (Square Meters),Name,State,County,Civilian Employed Population 16 Years and Over in Households that Have a Computer,Total Civilian Household Population 16 Years and Over,Population 16 Years and Over in the Civilian Labor Force in Households,Civilian Employed Population 16 Years and Over in Households,Civilian Employed Population 16 Years and Over in Households that Have a Computer with Dial-up Internet Subscription Alone,Civilian Employed Population 16 Years and Over in Households that Have a Computer with a Broadband Internet Subscription,Civilian Employed Population 16 Years and Over in Households that Have a Computer without an Internet Subscription,Civilian Employed Population 16 Years and Over in Households that Have No Computer,Civilian Unemployed Population 16 Years and Over in Households,Civilian Unemployed Population 16 Years and Over in Households that Have a Computer,Civilian Unemployed Population 16 Years and Over in Households that Have a Computer with dial-up Internet Subscription Alone,Civilian Unemployed Population 16 Years and Over in Households that Have a Computer with a Broadband Internet Subscription,Civilian Unemployed Population 16 Years and Over in Households that Have a Computer without an Internet Subscription,Civilian Unemployed Population 16 Years and Over in Households that Have No Computer,Population 16 Years and Over in Households who are Not in the Labor Force in Households,Population 16 Years and Over in Households who are Not in the Labor Force in Households that Have a Computer,Population 16 Years and Over in Households who are Not in the Labor Force in Households that Have a Computer with dial-up Internet Subscription Alone,Population 16 Years and Over in Households who are Not in the Labor Force in Households that Have a Computer with a Broadband Internet Subscription,Population 16 Years and Over in Households who are Not in the Labor Force in Households that Have a Computer without an Internet Subscription,Population 16 Years and Over in Households who are Not in the Labor Force in Households that Have No Computer,Population 16 Years and Over in Households that Have No Computer,Percent of Civilian Population 16 Years and Over in Households that Have No Computer,Percent of Civilian Employed Population 16 Years and Over in Households that Have No Computer,Percent of Civilian Unemployed Population 16 Years and Over in Households that Have No Computer,Percent of Population 16 Years and Over who are Not in the Labor Force in Households that Have No Computer,Shape Area,Shape Length
48167,11370,11370,36005000100,1677210,1035011,Census Tract 1,New York,Bronx County,0,0,0,0,0,0,0,0,0,0,0,0,0,0,0,0,0,0,0,0,0,,,,,2733873.5703125,6859.25690486936
48168,10473,10473,36005000200,479463,852046,Census Tract 2,New York,Bronx County,1502,3678,1873,1578,0,1423,79,76,295,295,0,295,0,0,1805,1666,0,1517,149,139,215,5.8,4.8,0.0,7.7,831678.45703125,5722.479185788871
48169,10473,10473,36005000400,770689,690794,Census Tract 4,New York,Bronx County,2757,4675,3050,2808,0,2568,189,51,242,242,0,242,0,0,1625,1289,0,1230,59,336,387,8.3,1.8,0.0,20.7,1558095.71484375,9823.2180303129
48170,10473,10473,36005001600,485079,0,Census Tract 16,New York,Bronx County,2197,4348,2469,2309,0,1918,279,112,160,148,0,102,46,12,1879,1489,0,1229,260,390,514,11.8,4.9,7.5,20.8,847812.59375,3898.1632323833
48171,10454,10454,36005001900,1668013,1143135,Census Tract 19,New York,Bronx County,1113,1714,1228,1125,0,1044,69,12,103,103,0,103,0,0,486,429,0,370,59,57,69,4.0,1.1,0.0,11.7,2859323.546875,12087.0136547957
48171,10455,10455,36005001900,1668013,1143135,Census Tract 19,New York,Bronx County,1113,1714,1228,1125,0,1044,69,12,103,103,0,103,0,0,486,429,0,370,59,57,69,4.0,1.1,0.0,11.7,2859323.546875,12087.0136547957
48172,10473,10473,36005002000,395564,0,Census Tract 20,New York,Bronx County,2704,7282,3343,2737,0,2345,359,33,606,442,0,382,60,164,3939,3382,0,2902,480,557,754,10.4,1.2,27.1,14.1,691343.82421875,3357.14609856151
48173,10454,10454,36005002300,104645,0,Census Tract 23,New York,Bronx County,1181,3611,1635,1356,0,959,222,175,279,184,0,174,10,95,1976,1337,0,1106,231,639,909,25.2,12.9,34.1,32.3,182844.9921875,1902.0481346114102
48174,10473,10473,36005002400,675911,263388,Census Tract 24,New York,Bronx County,131,131,131,131,0,131,0,0,0,0,0,0,0,0,0,0,0,0,0,0,0,0.0,0.0,,,1177585.3671875,6978.29190576802
48175,10454,10454,36005002500,127492,0,Census Tract 25,New York,Bronx County,2092,4338,2575,2361,15,1706,371,269,214,184,0,163,21,30,1763,1287,8,973,306,476,775,17.9,11.4,14.0,27.0,222750.40234375,2023.30158224368
48176,10454,10454,36005002701,82641,0,Census Tract 27.01,New York,Bronx County,947,1943,1058,979,18,820,109,32,79,66,9,57,0,13,885,683,8,523,152,202,247,12.7,3.3,16.5,22.8,144379.25,1678.0492237067301
48177,10454,10454,36005002702,155504,0,Census Tract 27.02,New York,Bronx County,1366,3220,1516,1385,0,1047,319,19,131,121,0,86,35,10,1704,1363,0,920,443,341,370,11.5,1.4,7.6,20.0,271689.64453125,2449.4611004308
48178,10473,10473,36005002800,414588,24677,Census Tract 28,New York,Bronx County,2293,4334,2462,2363,14,2053,226,70,99,76,0,76,0,23,1872,1367,13,1068,286,505,598,13.8,3.0,23.2,27.0,724673.65234375,3637.3372599283
48179,10454,10454,36005003100,154703,0,Census Tract 31,New York,Bronx County,879,1340,955,909,0,609,270,30,46,17,0,10,7,29,385,322,0,259,63,63,122,9.1,3.3,63.0,16.4,270317.39453125,2345.1645466916602
48179,10455,10455,36005003100,154703,0,Census Tract 31,New York,Bronx County,879,1340,955,909,0,609,270,30,46,17,0,10,7,29,385,322,0,259,63,63,122,9.1,3.3,63.0,16.4,270317.39453125,2345.1645466916602
48180,10454,10454,36005003300,152385,0,Census Tract 33,New York,Bronx County,761,2546,1083,829,0,636,125,68,254,225,0,164,61,29,1463,1202,0,975,227,261,358,14.1,8.2,11.4,17.8,266253.01171875,2403.0945969589498
48181,10454,10454,36005003500,142005,0,Census Tract 35,New York,Bronx County,1413,2808,1728,1520,0,1223,190,107,208,208,0,152,56,0,1080,803,0,665,138,277,384,13.7,7.0,0.0,25.6,248133.55078125,2330.37900682193
48181,10455,10455,36005003500,142005,0,Census Tract 35,New York,Bronx County,1413,2808,1728,1520,0,1223,190,107,208,208,0,152,56,0,1080,803,0,665,138,277,384,13.7,7.0,0.0,25.6,248133.55078125,2330.37900682193
48182,10455,10455,36005003700,165973,0,Census Tract 37,New York,Bronx County,96,261,140,128,0,73,23,32,12,0,0,0,0,12,121,78,0,43,35,43,87,33.3,25.0,100.0,35.5,290021.6015625,2229.12910939818
48183,10473,10473,36005003800,63397,0,Census Tract 38,New York,Bronx County,511,1105,660,562,0,483,28,51,98,86,0,86,0,12,445,290,0,270,20,155,218,19.7,9.1,12.2,34.8,110809.6953125,1399.5468912657502
48184,10454,10454,36005003900,216210,0,Census Tract 39,New York,Bronx County,2824,4999,3322,3004,0,2313,511,180,318,278,0,160,118,40,1677,1083,0,785,298,594,814,16.3,6.0,12.6,35.4,377786.3125,2986.2312009491498
48185,10472,10472,36005004001,123145,0,Census Tract 40.01,New York,Bronx County,583,1242,664,613,0,543,40,30,51,37,0,37,0,14,578,507,0,461,46,71,115,9.3,4.9,27.5,12.3,215292.390625,1981.8996576035897
48186,10454,10454,36005004100,184733,0,Census Tract 41,New York,Bronx County,1456,4027,1934,1668,0,1192,264,212,266,266,0,266,0,0,2093,1675,0,1624,51,418,630,15.6,12.7,0.0,20.0,322803.765625,2692.3462175612303
48187,10473,10473,36005004200,483356,0,Census Tract 42,New York,Bronx County,2174,5230,2447,2246,0,2118,56,72,201,201,0,134,67,0,2783,2192,0,1747,445,591,663,12.7,3.2,0.0,21.2,844931.96484375,4136.94984719945
48188,10454,10454,36005004300,225393,0,Census Tract 43,New York,Bronx County,1870,4447,2482,2061,0,1751,119,191,421,392,0,321,71,29,1965,1544,0,1253,291,421,641,14.4,9.3,6.9,21.4,393879.29296875,2613.62047317777
48188,10455,10455,36005004300,225393,0,Census Tract 43,New York,Bronx County,1870,4447,2482,2061,0,1751,119,191,421,392,0,321,71,29,1965,1544,0,1253,291,421,641,14.4,9.3,6.9,21.4,393879.29296875,2613.62047317777
48189,10472,10472,36005004400,265578,0,Census Tract 44,New York,Bronx County,1079,3224,1469,1137,0,989,90,58,332,262,0,188,74,70,1755,1481,0,1190,291,274,402,12.5,5.1,21.1,15.6,464282.89453125,3470.90034546296
48190,10473,10473,36005004600,135340,0,Census Tract 46,New York,Bronx County,614,1358,689,620,0,524,90,6,69,69,0,69,0,0,669,604,0,501,103,65,71,5.2,1.0,0.0,9.7,236569.76953125,2111.29685395732
48191,10472,10472,36005004800,150832,0,Census Tract 48,New York,Bronx County,1973,3596,2417,1991,0,1716,257,18,426,362,0,280,82,64,1179,917,0,676,241,262,344,9.6,0.9,15.0,22.2,263686.09375,2196.83539786601
48192,10472,10472,36005005001,97889,0,Census Tract 50.01,New York,Bronx County,1458,3501,1948,1704,0,1056,402,246,244,220,0,167,53,24,1553,1148,0,888,260,405,675,19.3,14.4,9.8,26.1,171121.546875,1694.28415675302
48193,10472,10472,36005005002,113902,0,Census Tract 50.02,New York,Bronx County,1785,3937,2364,2086,0,1395,390,301,278,278,0,209,69,0,1573,1142,0,927,215,431,732,18.6,14.4,0.0,27.4,199128.2578125,1829.0518695212197
48194,10451,10451,36005005100,510448,0,Census Tract 51,New York,Bronx County,1674,4042,1950,1751,0,1448,226,77,199,157,0,134,23,42,2092,1584,0,1257,327,508,627,15.5,4.4,21.1,24.3,859020.8671875,5328.35354699498
48194,10454,10454,36005005100,510448,0,Census Tract 51,New York,Bronx County,1674,4042,1950,1751,0,1448,226,77,199,157,0,134,23,42,2092,1584,0,1257,327,508,627,15.5,4.4,21.1,24.3,859020.8671875,5328.35354699498
48195,10472,10472,36005005200,182689,0,Census Tract 52,New York,Bronx County,707,1555,844,831,0,620,87,124,13,8,0,6,2,5,711,427,5,318,104,284,413,26.6,14.9,38.5,39.9,319367.328125,2323.6470263414103
48196,10453,10453,36005005300,68745,3852,Census Tract 53,New York,Bronx County,858,2796,1328,938,0,689,169,80,390,289,0,208,81,101,1468,1207,0,932,275,261,442,15.8,8.5,25.9,17.8,117559.46875,1676.8115877299801
48197,10472,10472,36005005400,196516,0,Census Tract 54,New York,Bronx County,2488,4563,2809,2599,0,1729,759,111,210,210,0,200,10,0,1754,1428,0,1038,390,326,437,9.6,4.3,0.0,18.6,343582.0546875,2566.93009285853
48198,10472,10472,36005005600,136188,0,Census Tract 56,New York,Bronx County,744,1870,953,808,0,662,82,64,145,125,0,125,0,20,917,594,0,503,91,323,407,21.8,7.9,13.8,35.2,238126.6875,2001.16133017345
48199,10451,10451,36005005902,69637,0,Census Tract 59.02,New York,Bronx County,1032,2039,1126,1087,0,889,143,55,39,39,0,39,0,0,913,832,0,783,49,81,136,6.7,5.1,0.0,8.9,121729.30078125,2083.80308895687
48200,10460,10460,36005006000,315748,0,Census Tract 60,New York,Bronx County,569,1169,654,580,0,560,9,11,74,74,0,74,0,0,515,488,0,453,35,27,38,3.3,1.9,0.0,5.2,552174.80859375,3164.9106567489303
48201,10451,10451,36005006100,242362,0,Census Tract 61,New York,Bronx County,1551,3439,1881,1708,0,1479,72,157,173,173,0,173,0,0,1558,1294,8,963,323,264,421,12.2,9.2,0.0,16.9,423640.12109375,3358.04672175313
48202,10472,10472,36005006200,192942,0,Census Tract 62,New York,Bronx County,2070,5121,2856,2472,0,1849,221,402,384,384,0,384,0,0,2265,1576,0,1192,384,689,1091,21.3,16.3,0.0,30.4,337370.8359375,2910.20250703137
48203,10451,10451,36005006300,1046237,9963,Census Tract 63,New York,Bronx County,2073,3448,2358,2154,0,1705,368,81,204,204,0,155,49,0,1090,878,16,723,139,212,293,8.5,3.8,0.0,19.4,1793845.22265625,8388.45729342265
48203,10452,10452,36005006300,1046237,9963,Census Tract 63,New York,Bronx County,2073,3448,2358,2154,0,1705,368,81,204,204,0,155,49,0,1090,878,16,723,139,212,293,8.5,3.8,0.0,19.4,1793845.22265625,8388.45729342265
48204,10472,10472,36005006400,168249,0,Census Tract 64,New York,Bronx County,1261,2745,1416,1352,0,991,270,91,64,64,0,40,24,0,1329,775,0,627,148,554,645,23.5,6.7,0.0,41.7,294191.28515625,2351.12302806701
48205,10451,10451,36005006500,261808,0,Census Tract 65,New York,Bronx County,1933,3837,2294,2057,0,1806,127,124,237,231,0,188,43,6,1543,1153,0,880,273,390,520,13.6,6.0,2.5,25.3,457567.75390625,3951.1272632859495
48205,10455,10455,36005006500,261808,0,Census Tract 65,New York,Bronx County,1933,3837,2294,2057,0,1806,127,124,237,231,0,188,43,6,1543,1153,0,880,273,390,520,13.6,6.0,2.5,25.3,457567.75390625,3951.1272632859495
48206,10451,10451,36005006700,212430,0,Census Tract 67,New York,Bronx County,2223,5362,2742,2393,0,1697,526,170,349,349,0,255,94,0,2620,2064,0,1398,666,556,726,13.5,7.1,0.0,21.2,371291.078125,2629.39409586561
48206,10455,10455,36005006700,212430,0,Census Tract 67,New York,Bronx County,2223,5362,2742,2393,0,1697,526,170,349,349,0,255,94,0,2620,2064,0,1398,666,556,726,13.5,7.1,0.0,21.2,371291.078125,2629.39409586561
48207,10472,10472,36005006800,154374,0,Census Tract 68,New York,Bronx County,1343,2467,1590,1462,16,1060,267,119,128,128,0,55,73,0,877,769,27,710,32,108,227,9.2,8.1,0.0,12.3,269893.3671875,2244.35394162728
48208,10451,10451,36005006900,187977,0,Census Tract 69,New York,Bronx County,3008,5717,3273,3091,0,2687,321,83,182,182,0,148,34,0,2444,1907,0,1301,606,537,620,10.8,2.7,0.0,22.0,328576.015625,2631.9937899696
48208,10455,10455,36005006900,187977,0,Census Tract 69,New York,Bronx County,3008,5717,3273,3091,0,2687,321,83,182,182,0,148,34,0,2444,1907,0,1301,606,537,620,10.8,2.7,0.0,22.0,328576.015625,2631.9937899696
48209,10472,10472,36005007000,204891,0,Census Tract 70,New York,Bronx County,1847,3563,2008,1899,0,1709,138,52,109,109,0,98,11,0,1555,1353,0,1260,93,202,254,7.1,2.7,0.0,13.0,358224.9375,2511.64731016121
48210,10451,10451,36005007100,264262,0,Census Tract 71,New York,Bronx County,1249,2049,1408,1263,0,1114,135,14,145,125,0,118,7,20,641,528,0,444,84,113,147,7.2,1.1,13.8,17.6,461864.9921875,3476.0949424859496
48210,10455,10455,36005007100,264262,0,Census Tract 71,New York,Bronx County,1249,2049,1408,1263,0,1114,135,14,145,125,0,118,7,20,641,528,0,444,84,113,147,7.2,1.1,13.8,17.6,461864.9921875,3476.0949424859496
48210,10456,10456,36005007100,264262,0,Census Tract 71,New York,Bronx County,1249,2049,1408,1263,0,1114,135,14,145,125,0,118,7,20,641,528,0,444,84,113,147,7.2,1.1,13.8,17.6,461864.9921875,3476.0949424859496
48211,10472,10472,36005007200,213050,0,Census Tract 72,New York,Bronx County,2262,4575,2594,2316,10,1849,403,54,278,248,0,235,13,30,1981,1762,18,1385,359,219,303,6.6,2.3,10.8,11.1,372503.203125,2997.19097519659
48212,10455,10455,36005007300,140161,0,Census Tract 73,New York,Bronx County,1284,3020,1549,1343,0,983,301,59,206,187,0,103,84,19,1471,1114,0,704,410,357,435,14.4,4.4,9.2,24.3,244939.6484375,2046.2332310006698
48213,10473,10473,36005007400,187162,0,Census Tract 74,New York,Bronx County,1476,2706,1597,1498,0,1263,213,22,99,99,0,73,26,0,1109,1031,0,753,278,78,100,3.7,1.5,0.0,7.0,327126.5625,2584.65926290808
48214,10455,10455,36005007500,227618,0,Census Tract 75,New York,Bronx County,2100,4456,2431,2203,0,1757,343,103,228,228,0,213,15,0,2025,1420,0,1209,211,605,708,15.9,4.7,0.0,29.9,397828.0,2948.8213031434
48214,10456,10456,36005007500,227618,0,Census Tract 75,New York,Bronx County,2100,4456,2431,2203,0,1757,343,103,228,228,0,213,15,0,2025,1420,0,1209,211,605,708,15.9,4.7,0.0,29.9,397828.0,2948.8213031434
48215,10472,10472,36005007600,217217,0,Census Tract 76,New York,Bronx County,1931,4199,2384,2116,0,1566,365,185,268,197,0,181,16,71,1815,1683,0,1485,198,132,388,9.2,8.7,26.5,7.3,379812.50390625,2682.26680639098
48216,10455,10455,36005007700,112827,0,Census Tract 77,New York,Bronx County,734,1440,848,755,0,612,122,21,93,93,0,84,9,0,592,450,0,417,33,142,163,11.3,2.8,0.0,24.0,197201.9140625,1813.3161524491
48216,10456,10456,36005007700,112827,0,Census Tract 77,New York,Bronx County,734,1440,848,755,0,612,122,21,93,93,0,84,9,0,592,450,0,417,33,142,163,11.3,2.8,0.0,24.0,197201.9140625,1813.3161524491
48216,10459,10459,36005007700,112827,0,Census Tract 77,New York,Bronx County,734,1440,848,755,0,612,122,21,93,93,0,84,9,0,592,450,0,417,33,142,163,11.3,2.8,0.0,24.0,197201.9140625,1813.3161524491
48217,10472,10472,36005007800,311879,0,Census Tract 78,New York,Bronx County,2675,5405,3155,2902,41,2182,452,227,253,236,0,217,19,17,2250,1907,0,1669,238,343,587,10.9,7.8,6.7,15.2,545271.1328125,3558.5982149183797
48218,10455,10455,36005007900,197930,0,Census Tract 79,New York,Bronx County,2154,4951,2661,2325,0,1664,490,171,336,287,0,246,41,49,2290,1749,0,1476,273,541,761,15.4,7.4,14.6,23.6,345908.73046875,3026.8942589926896
48219,10455,10455,36005008300,213932,0,Census Tract 83,New York,Bronx County,2625,4959,3219,2734,0,2425,200,109,485,485,0,379,106,0,1740,1508,0,1255,253,232,341,6.9,4.0,0.0,13.3,373852.25390625,2758.66681398839
48220,10473,10473,36005008400,156789,0,Census Tract 84,New York,Bronx County,1280,2136,1401,1318,0,1213,67,38,83,83,0,59,24,0,735,663,0,626,37,72,110,5.1,2.9,0.0,9.8,274010.0078125,2644.06542709036
48221,10455,10455,36005008500,181658,0,Census Tract 85,New York,Bronx County,1942,4031,2236,2046,0,1750,192,104,190,190,0,146,44,0,1795,1350,0,1093,257,445,549,13.6,5.1,0.0,24.8,317476.48828125,2600.68543501319
48221,10459,10459,36005008500,181658,0,Census Tract 85,New York,Bronx County,1942,4031,2236,2046,0,1750,192,104,190,190,0,146,44,0,1795,1350,0,1093,257,445,549,13.6,5.1,0.0,24.8,317476.48828125,2600.68543501319
48222,10473,10473,36005008600,187658,0,Census Tract 86,New York,Bronx County,1366,3046,1497,1397,0,1111,255,31,100,92,0,50,42,8,1549,1282,0,701,581,267,306,10.0,2.2,8.0,17.2,327997.58203125,2589.4099737611105
48223,10459,10459,36005008700,213574,0,Census Tract 87,New York,Bronx County,2147,4641,2588,2262,0,1859,288,115,326,291,0,257,34,35,2053,1381,0,1100,281,672,822,17.7,5.1,10.7,32.7,373289.80859375,2801.5376865798803
48224,10459,10459,36005008900,110291,0,Census Tract 89,New York,Bronx County,1023,2415,1229,1120,0,878,145,97,109,109,0,109,0,0,1186,732,0,625,107,454,551,22.8,8.7,0.0,38.3,192765.80078125,2102.59626956035
48225,10465,10465,36005009000,1024677,1162033,Census Tract 90,New York,Bronx County,908,2823,1095,973,0,809,99,65,122,122,0,115,7,0,1728,1553,0,1026,527,175,240,8.5,6.7,0.0,10.1,1778745.59375,11670.9095454748
48225,10473,10473,36005009000,1024677,1162033,Census Tract 90,New York,Bronx County,908,2823,1095,973,0,809,99,65,122,122,0,115,7,0,1728,1553,0,1026,527,175,240,8.5,6.7,0.0,10.1,1778745.59375,11670.9095454748
48226,10462,10462,36005009200,310475,0,Census Tract 92,New York,Bronx County,2661,4698,3203,2711,0,2415,246,50,492,492,0,483,9,0,1495,1256,0,1081,175,239,289,6.2,1.8,0.0,16.0,542861.55859375,3696.42321185825
48227,10455,10455,36005009300,2307627,1595761,Census Tract 93,New York,Bronx County,1887,4087,2141,1984,0,1645,242,97,157,138,0,138,0,19,1946,1439,0,1170,269,507,623,15.2,4.9,12.1,26.1,4018113.5390625,10812.8062755401
48227,10474,10474,36005009300,2307627,1595761,Census Tract 93,New York,Bronx County,1887,4087,2141,1984,0,1645,242,97,157,138,0,138,0,19,1946,1439,0,1170,269,507,623,15.2,4.9,12.1,26.1,4018113.5390625,10812.8062755401
48228,10461,10461,36005009600,703455,15353,Census Tract 96,New York,Bronx County,865,1932,1118,907,0,823,42,42,211,211,0,191,20,0,814,691,0,573,118,123,165,8.5,4.6,0.0,15.1,1256916.20703125,5046.2527646485105
48228,10462,10462,36005009600,703455,15353,Census Tract 96,New York,Bronx County,865,1932,1118,907,0,823,42,42,211,211,0,191,20,0,814,691,0,573,118,123,165,8.5,4.6,0.0,15.1,1256916.20703125,5046.2527646485105
48229,10473,10473,36005009800,517450,0,Census Tract 98,New York,Bronx County,2160,3889,2540,2356,0,2101,59,196,184,184,0,184,0,0,1349,1205,0,1126,79,144,340,8.7,8.3,0.0,10.7,904578.65234375,4113.522147690979
48230,10465,10465,36005011000,2069297,452399,Census Tract 110,New York,Bronx County,0,0,0,0,0,0,0,0,0,0,0,0,0,0,0,0,0,0,0,0,0,,,,,3607727.734375,10518.245501281
48231,10474,10474,36005011502,336295,10037,Census Tract 115.02,New York,Bronx County,1348,2816,1602,1419,0,1310,38,71,183,155,0,95,60,28,1214,879,0,812,67,335,434,15.4,5.0,15.3,27.6,587784.43359375,3064.39179160365
48232,10474,10474,36005011700,1357971,431176,Census Tract 117,New York,Bronx County,551,1209,716,595,0,508,43,44,121,121,0,114,7,0,493,448,0,351,97,45,89,7.4,7.4,0.0,9.1,2391680.265625,7067.76299011948
48233,10465,10465,36005011800,989676,2876319,Census Tract 118,New York,Bronx County,1834,3303,1928,1859,0,1821,13,25,69,69,0,69,0,0,1375,1156,16,1022,118,219,244,7.4,1.3,0.0,15.9,1890836.83203125,11249.0442814835
48234,10459,10459,36005011900,166999,0,Census Tract 119,New York,Bronx County,1890,4109,2268,1955,0,1697,193,65,313,313,0,313,0,0,1841,1429,0,1268,161,412,477,11.6,3.3,0.0,22.4,291913.44921875,2224.33813512231
48235,10459,10459,36005012101,115615,0,Census Tract 121.01,New York,Bronx County,1055,2174,1295,1205,0,925,130,150,90,84,0,79,5,6,879,705,0,599,106,174,330,15.2,12.4,6.7,19.8,202128.125,1772.99151230862
48236,10459,10459,36005012102,49643,0,Census Tract 121.02,New York,Bronx County,472,1216,597,488,0,428,44,16,109,109,0,102,7,0,619,573,0,357,216,46,62,5.1,3.3,0.0,7.4,86781.94921875,1605.2300759498598
48237,10459,10459,36005012300,303328,0,Census Tract 123,New York,Bronx County,1570,3151,1722,1671,0,1274,296,101,51,51,0,51,0,0,1429,1135,0,957,178,294,395,12.5,6.0,0.0,20.6,530310.2734375,4718.59805070936
48238,10459,10459,36005012500,169640,0,Census Tract 125,New York,Bronx County,1563,3180,1874,1660,0,1361,202,97,214,214,0,145,69,0,1306,1188,0,854,334,118,215,6.8,5.8,0.0,9.0,296580.72265625,2304.97379088801
48239,10459,10459,36005012701,108718,0,Census Tract 127.01,New York,Bronx County,638,1424,700,693,11,541,86,55,7,7,0,0,7,0,724,546,0,385,161,178,233,16.4,7.9,0.0,24.6,190054.83984375,2035.85651320768
48240,10459,10459,36005012901,156381,0,Census Tract 129.01,New York,Bronx County,1161,2802,1373,1262,15,1076,70,101,111,96,0,73,23,15,1429,1025,0,822,203,404,520,18.6,8.0,13.5,28.3,273351.87890625,2864.0508400157696
48241,10465,10465,36005013000,116144,0,Census Tract 130,New York,Bronx County,843,1287,930,843,0,826,17,0,87,87,0,87,0,0,357,323,0,323,0,34,34,2.6,0.0,0.0,9.5,202995.859375,2603.96638235619
48242,10456,10456,36005013100,230967,0,Census Tract 131,New York,Bronx County,1816,3637,2168,1911,0,1679,137,95,257,257,0,198,59,0,1469,1066,8,931,127,403,498,13.7,5.0,0.0,27.4,403769.27734375,2638.68078784506
48242,10459,10459,36005013100,230967,0,Census Tract 131,New York,Bronx County,1816,3637,2168,1911,0,1679,137,95,257,257,0,198,59,0,1469,1066,8,931,127,403,498,13.7,5.0,0.0,27.4,403769.27734375,2638.68078784506
48243,10465,10465,36005013200,604268,925089,Census Tract 132,New York,Bronx County,3779,5614,3944,3805,0,3386,393,26,139,139,0,139,0,0,1670,1393,0,1261,132,277,303,5.4,0.7,0.0,16.6,1056027.2578125,5396.18469829902
48244,10456,10456,36005013300,161159,0,Census Tract 133,New York,Bronx County,1972,4843,2468,2216,0,1919,53,244,252,218,0,218,0,34,2375,1467,0,1204,263,908,1186,24.5,11.0,13.5,38.2,281705.94921875,2306.73251948218
48244,10459,10459,36005013300,161159,0,Census Tract 133,New York,Bronx County,1972,4843,2468,2216,0,1919,53,244,252,218,0,218,0,34,2375,1467,0,1204,263,908,1186,24.5,11.0,13.5,38.2,281705.94921875,2306.73251948218
48245,10456,10456,36005013500,167404,0,Census Tract 135,New York,Bronx County,1159,2631,1414,1290,0,980,179,131,124,124,0,44,80,0,1217,817,0,746,71,400,531,20.2,10.2,0.0,32.9,292660.25,2817.16890071038
48245,10459,10459,36005013500,167404,0,Census Tract 135,New York,Bronx County,1159,2631,1414,1290,0,980,179,131,124,124,0,44,80,0,1217,817,0,746,71,400,531,20.2,10.2,0.0,32.9,292660.25,2817.16890071038
48246,10465,10465,36005013800,764724,3460640,Census Tract 138,New York,Bronx County,1211,2097,1303,1232,0,1065,146,21,71,71,0,59,12,0,794,668,0,591,77,126,147,7.0,1.7,0.0,15.9,1326894.75,8061.92374502655
48247,10451,10451,36005014100,177165,0,Census Tract 141,New York,Bronx County,2316,4216,2566,2377,0,1950,366,61,189,181,0,156,25,8,1650,1377,0,1190,187,273,342,8.1,2.6,4.2,16.5,309693.84765625,2737.97271445901
48247,10456,10456,36005014100,177165,0,Census Tract 141,New York,Bronx County,2316,4216,2566,2377,0,1950,366,61,189,181,0,156,25,8,1650,1377,0,1190,187,273,342,8.1,2.6,4.2,16.5,309693.84765625,2737.97271445901
48248,10451,10451,36005014300,129711,0,Census Tract 143,New York,Bronx County,514,1065,567,514,0,486,28,0,53,53,0,40,13,0,498,385,0,305,80,113,113,10.6,0.0,0.0,22.7,226768.18359375,2708.16081933577
48248,10456,10456,36005014300,129711,0,Census Tract 143,New York,Bronx County,514,1065,567,514,0,486,28,0,53,53,0,40,13,0,498,385,0,305,80,113,113,10.6,0.0,0.0,22.7,226768.18359375,2708.16081933577
48249,10465,10465,36005014400,401253,0,Census Tract 144,New York,Bronx County,1695,4263,2210,1874,0,1642,53,179,336,336,0,293,43,0,2053,1356,0,1216,140,697,876,20.5,9.6,0.0,34.0,701353.359375,3974.3978883561
48250,10456,10456,36005014500,181445,0,Census Tract 145,New York,Bronx County,2133,5288,2886,2412,0,1699,434,279,474,440,0,363,77,34,2402,2141,0,1463,678,261,574,10.9,11.6,7.2,10.9,317248.94921875,2265.90520375475
48251,10456,10456,36005014701,138921,0,Census Tract 147.01,New York,Bronx County,1484,4805,2248,1655,0,1079,405,171,593,506,0,343,163,87,2557,1607,0,1065,542,950,1208,25.1,10.3,14.7,37.2,242916.4921875,2062.22489845716
48252,10456,10456,36005014702,116305,0,Census Tract 147.02,New York,Bronx County,1776,3909,1942,1826,0,1607,169,50,116,116,0,116,0,0,1967,1504,0,1306,198,463,513,13.1,2.7,0.0,23.5,203384.71875,2077.3993578089603
48253,10456,10456,36005014900,155523,0,Census Tract 149,New York,Bronx County,1695,3397,2042,1787,40,1493,162,92,255,232,0,232,0,23,1355,1183,0,873,310,172,287,8.4,5.1,9.0,12.7,271933.28515625,2373.97206142702
48254,10456,10456,36005015100,208929,0,Census Tract 151,New York,Bronx County,2083,3696,2426,2159,0,1801,282,76,267,238,0,217,21,29,1270,1034,0,859,175,236,341,9.2,3.5,10.9,18.6,365296.69140625,3049.16812277025
48254,10459,10459,36005015100,208929,0,Census Tract 151,New York,Bronx County,2083,3696,2426,2159,0,1801,282,76,267,238,0,217,21,29,1270,1034,0,859,175,236,341,9.2,3.5,10.9,18.6,365296.69140625,3049.16812277025
48255,10465,10465,36005015200,284310,0,Census Tract 152,New York,Bronx County,1153,2051,1322,1170,0,1077,76,17,152,152,0,145,7,0,729,603,0,539,64,126,143,7.0,1.5,0.0,17.3,497026.79296875,3556.6764062996294
48256,10459,10459,36005015300,236838,0,Census Tract 153,New York,Bronx County,1672,3495,1935,1744,0,1419,253,72,191,182,0,182,0,9,1560,1314,0,980,334,246,327,9.4,4.1,4.7,15.8,414123.29296875,2940.3634016848305
48256,10460,10460,36005015300,236838,0,Census Tract 153,New York,Bronx County,1672,3495,1935,1744,0,1419,253,72,191,182,0,182,0,9,1560,1314,0,980,334,246,327,9.4,4.1,4.7,15.8,414123.29296875,2940.3634016848305
48257,10460,10460,36005015500,114986,0,Census Tract 155,New York,Bronx County,908,2147,1213,1072,0,798,110,164,141,118,0,71,47,23,934,752,0,553,199,182,369,17.2,15.3,16.3,19.5,201071.3046875,2354.6230111264003
48258,10459,10459,36005015700,319009,0,Census Tract 157,New York,Bronx County,1846,3481,2246,1974,0,1451,395,128,272,241,0,145,96,31,1235,1126,0,603,523,109,268,7.7,6.5,11.4,8.8,557796.71875,3436.6027618747
48258,10460,10460,36005015700,319009,0,Census Tract 157,New York,Bronx County,1846,3481,2246,1974,0,1451,395,128,272,241,0,145,96,31,1235,1126,0,603,523,109,268,7.7,6.5,11.4,8.8,557796.71875,3436.6027618747
48259,10465,10465,36005015800,162176,0,Census Tract 158,New York,Bronx County,429,860,493,463,7,408,14,34,30,30,0,23,7,0,367,254,6,236,12,113,147,17.1,7.3,0.0,30.8,283500.6875,2377.2475312228603
48260,10459,10459,36005015900,103601,0,Census Tract 159,New York,Bronx County,539,1594,614,575,0,515,24,36,39,32,0,32,0,7,980,736,0,667,69,244,287,18.0,6.3,17.9,24.9,181094.4296875,1798.5643908026102
48261,10465,10465,36005016000,494499,2614648,Census Tract 160,New York,Bronx County,1875,3183,2036,1913,8,1748,119,38,123,123,0,123,0,0,1147,1040,8,984,48,107,145,4.6,2.0,0.0,9.3,864599.6953125,4532.315872956579
48262,10460,10460,36005016100,239125,0,Census Tract 161,New York,Bronx County,1692,3149,1996,1748,0,1310,382,56,248,227,0,140,87,21,1153,798,0,549,249,355,432,13.7,3.2,8.5,30.8,418166.8671875,2637.33535188802
48263,10465,10465,36005016200,180646,0,Census Tract 162,New York,Bronx County,861,1443,923,875,0,853,8,14,48,41,0,41,0,7,520,438,0,424,14,82,103,7.1,1.6,14.6,15.8,315824.4296875,2256.61850571113
48265,10465,10465,36005016400,164578,0,Census Tract 164,New York,Bronx County,438,847,472,450,0,388,50,12,22,22,0,22,0,0,375,319,0,268,51,56,68,8.0,2.7,0.0,14.9,287764.171875,2214.6683001432298
48266,10457,10457,36005016500,196842,0,Census Tract 165,New York,Bronx County,357,675,399,361,0,302,55,4,38,38,0,38,0,0,276,230,0,194,36,46,50,7.4,1.1,0.0,16.7,344291.94921875,3033.72507949144
48267,10465,10465,36005016600,285611,0,Census Tract 166,New York,Bronx County,1094,1896,1209,1110,7,934,153,16,99,99,0,73,26,0,687,602,12,494,96,85,101,5.3,1.4,0.0,12.4,499343.453125,3136.8345873781104
48268,10457,10457,36005016700,205837,0,Census Tract 167,New York,Bronx County,1060,2078,1294,1140,0,891,169,80,154,123,0,97,26,31,784,595,0,446,149,189,300,14.4,7.0,20.1,24.1,359995.0390625,2651.64288457806
48269,10456,10456,36005016900,92915,0,Census Tract 169,New York,Bronx County,523,1051,600,523,0,425,98,0,77,77,0,34,43,0,451,359,0,329,30,92,92,8.8,0.0,0.0,20.4,162487.62109375,2121.41880934959
48269,10457,10457,36005016900,92915,0,Census Tract 169,New York,Bronx County,523,1051,600,523,0,425,98,0,77,77,0,34,43,0,451,359,0,329,30,92,92,8.8,0.0,0.0,20.4,162487.62109375,2121.41880934959
48271,10451,10451,36005017300,165273,0,Census Tract 173,New York,Bronx County,1887,4668,2285,2131,0,1621,266,244,154,154,0,154,0,0,2383,1694,0,1491,203,689,933,20.0,11.5,0.0,28.9,288928.48828125,2984.1573937755998
48271,10456,10456,36005017300,165273,0,Census Tract 173,New York,Bronx County,1887,4668,2285,2131,0,1621,266,244,154,154,0,154,0,0,2383,1694,0,1491,203,689,933,20.0,11.5,0.0,28.9,288928.48828125,2984.1573937755998
48272,10456,10456,36005017500,151593,0,Census Tract 175,New York,Bronx County,2346,5479,2991,2628,0,1909,437,282,363,325,0,248,77,38,2488,1526,0,987,539,962,1282,23.4,10.7,10.5,38.7,265047.03515625,2307.52987670339
48273,10456,10456,36005017701,106630,0,Census Tract 177.01,New York,Bronx County,1955,3105,2298,2072,0,1756,199,117,226,226,0,226,0,0,807,595,0,564,31,212,329,10.6,5.6,0.0,26.3,186445.9765625,2115.1931103610896
48274,10456,10456,36005017702,140906,0,Census Tract 177.02,New York,Bronx County,2146,4405,2674,2249,0,1998,148,103,425,379,0,300,79,46,1731,1415,0,1250,165,316,465,10.6,4.6,10.8,18.3,246402.640625,2777.46021922312
48275,10456,10456,36005017901,76723,0,Census Tract 179.01,New York,Bronx County,1837,3718,2218,2046,6,1639,192,209,172,139,0,117,22,33,1500,1215,0,922,293,285,527,14.2,10.2,19.2,19.0,134159.75390625,1478.31743852336
48276,10456,10456,36005017902,77544,0,Census Tract 179.02,New York,Bronx County,1486,2829,1734,1517,0,1243,243,31,217,185,0,170,15,32,1095,954,0,687,267,141,204,7.2,2.0,14.7,12.9,135603.44921875,1493.7320809453602
48277,10456,10456,36005018101,77226,0,Census Tract 181.01,New York,Bronx County,1211,2295,1394,1284,0,1086,125,73,110,110,0,91,19,0,901,805,0,647,158,96,169,7.4,5.7,0.0,10.7,135026.37890625,1690.5805010178399
48278,10456,10456,36005018102,96381,0,Census Tract 181.02,New York,Bronx County,2016,3858,2523,2102,0,1840,176,86,421,421,0,421,0,0,1335,1115,0,1032,83,220,306,7.9,4.1,0.0,16.5,168522.65625,1753.08372753917
48279,10451,10451,36005018301,67872,0,Census Tract 183.01,New York,Bronx County,1727,3395,1985,1817,0,1549,178,90,168,168,0,168,0,0,1410,772,0,553,219,638,728,21.4,5.0,0.0,45.2,118663.70703125,1646.1911532015301
48280,10451,10451,36005018302,112287,0,Census Tract 183.02,New York,Bronx County,1696,2948,1886,1728,10,1451,235,32,158,158,0,124,34,0,1062,922,0,783,139,140,172,5.8,1.9,0.0,13.2,196308.55078125,1866.3289901111102
48280,10456,10456,36005018302,112287,0,Census Tract 183.02,New York,Bronx County,1696,2948,1886,1728,10,1451,235,32,158,158,0,124,34,0,1062,922,0,783,139,140,172,5.8,1.9,0.0,13.2,196308.55078125,1866.3289901111102
48281,10461,10461,36005018400,447411,0,Census Tract 184,New York,Bronx County,1867,3316,2046,1934,0,1698,169,67,112,101,0,101,0,11,1270,1074,0,980,94,196,274,8.3,3.5,9.8,15.4,782422.40625,3668.43017552993
48282,10456,10456,36005018500,412150,0,Census Tract 185,New York,Bronx County,2997,5940,3609,3231,0,2623,374,234,378,356,0,291,65,22,2331,1706,0,1359,347,625,881,14.8,7.2,5.8,26.8,720522.078125,4160.4666817528605
48283,10452,10452,36005018900,355570,0,Census Tract 189,New York,Bronx County,3272,5887,3468,3323,0,2758,514,51,145,145,0,145,0,0,2419,2075,0,1622,453,344,395,6.7,1.5,0.0,14.2,612472.41796875,3182.74605972401
48284,10452,10452,36005019300,241287,0,Census Tract 193,New York,Bronx County,1670,4286,2278,1853,18,1246,406,183,425,425,24,337,64,0,2008,1461,88,881,492,547,730,17.0,9.9,0.0,27.2,421939.19140625,3658.52204334498
48285,10461,10461,36005019400,840070,393,Census Tract 194,New York,Bronx County,905,1795,1051,920,1,866,38,15,131,131,0,92,39,0,744,616,3,579,34,128,143,8.0,1.6,0.0,17.2,1469595.51953125,5724.11846687223
48285,10465,10465,36005019400,840070,393,Census Tract 194,New York,Bronx County,905,1795,1051,920,1,866,38,15,131,131,0,92,39,0,744,616,3,579,34,128,143,8.0,1.6,0.0,17.2,1469595.51953125,5724.11846687223
48286,10452,10452,36005019500,219844,0,Census Tract 195,New York,Bronx County,2914,5618,3441,3027,0,2429,485,113,414,394,0,306,88,20,2177,1754,0,1375,379,423,556,9.9,3.7,4.8,19.4,384375.4375,2803.09596526002
48287,10452,10452,36005019700,148088,0,Census Tract 197,New York,Bronx County,2997,5225,3358,3081,0,2685,312,84,277,277,0,239,38,0,1867,1444,0,1284,160,423,507,9.7,2.7,0.0,22.7,258956.16796875,2144.06655405159
48288,10452,10452,36005019900,177088,0,Census Tract 199,New York,Bronx County,3686,6419,4318,3923,0,2926,760,237,395,395,0,324,71,0,2101,1745,0,1255,490,356,593,9.2,6.0,0.0,16.9,309677.8984375,2337.60406376735
48289,10461,10461,36005020000,341895,0,Census Tract 200,New York,Bronx County,1824,3302,2163,1865,0,1649,175,41,298,298,0,269,29,0,1139,996,0,826,170,143,184,5.6,2.2,0.0,12.6,597988.75390625,4438.33985940632
48290,10452,10452,36005020100,282706,0,Census Tract 201,New York,Bronx County,1433,2907,1624,1576,0,1195,238,143,48,27,0,13,14,21,1283,1095,0,862,233,188,352,12.1,9.1,43.8,14.7,494448.79296875,2990.9633933433897
48291,10461,10461,36005020200,124809,0,Census Tract 202,New York,Bronx County,979,1740,1073,1014,0,911,68,35,59,57,0,57,0,2,667,456,0,390,66,211,248,14.3,3.5,3.4,31.6,218268.11328125,1913.4857903382199
48291,10462,10462,36005020200,124809,0,Census Tract 202,New York,Bronx County,979,1740,1073,1014,0,911,68,35,59,57,0,57,0,2,667,456,0,390,66,211,248,14.3,3.5,3.4,31.6,218268.11328125,1913.4857903382199
48292,10461,10461,36005020400,134282,0,Census Tract 204,New York,Bronx County,1438,2568,1682,1518,0,1290,148,80,164,139,0,111,28,25,886,709,0,647,62,177,282,11.0,5.3,15.2,20.0,234852.02734375,1913.28586091935
48292,10462,10462,36005020400,134282,0,Census Tract 204,New York,Bronx County,1438,2568,1682,1518,0,1290,148,80,164,139,0,111,28,25,886,709,0,647,62,177,282,11.0,5.3,15.2,20.0,234852.02734375,1913.28586091935
48293,10453,10453,36005020501,268164,0,Census Tract 205.01,New York,Bronx County,2446,5472,3018,2616,16,2052,378,170,402,389,17,195,177,13,2454,2011,16,1597,398,443,626,11.4,6.5,3.2,18.1,469085.45703125,3025.0025967718398
48294,10453,10453,36005020502,101460,0,Census Tract 205.02,New York,Bronx County,746,1672,900,783,0,673,73,37,117,112,0,93,19,5,772,574,0,443,131,198,240,14.4,4.7,4.3,25.6,177505.12109375,1773.6159791161301
48295,10462,10462,36005020601,151551,0,Census Tract 206.01,New York,Bronx County,826,1897,1072,951,0,666,160,125,121,81,0,81,0,40,825,661,9,520,132,164,329,17.3,13.1,33.1,19.9,265019.05859375,2324.8228675321698
48296,10452,10452,36005020900,132467,0,Census Tract 209,New York,Bronx County,1785,3635,2018,1964,0,1667,118,179,54,54,0,54,0,0,1617,1367,0,1150,217,250,429,11.8,9.1,0.0,15.5,231692.0390625,2092.62644909925
48297,10462,10462,36005021001,192403,0,Census Tract 210.01,New York,Bronx County,4615,7209,5144,4734,0,4146,469,119,410,399,0,345,54,11,2065,1451,0,1203,248,614,744,10.3,2.5,2.7,29.7,336499.8046875,2872.55407342158
48298,10462,10462,36005021002,172052,0,Census Tract 210.02,New York,Bronx County,3981,6101,4473,4003,0,3831,150,22,470,470,0,470,0,0,1628,1391,0,1256,135,237,259,4.2,0.5,0.0,14.6,300889.16796875,2462.4346264767
48299,10452,10452,36005021100,153028,0,Census Tract 211,New York,Bronx County,1834,3533,2375,2032,0,1679,155,198,343,272,0,225,47,71,1158,876,0,720,156,282,551,15.6,9.7,20.7,24.4,267634.5703125,2510.8487334163
48300,10462,10462,36005021200,101018,0,Census Tract 212,New York,Bronx County,2213,4065,2706,2444,0,2057,156,231,262,262,0,224,38,0,1359,1224,0,1090,134,135,366,9.0,9.5,0.0,9.9,176651.859375,1717.65144381656
48301,10452,10452,36005021301,65397,0,Census Tract 213.01,New York,Bronx County,540,978,630,564,7,502,31,24,66,54,9,45,0,12,348,292,0,247,45,56,92,9.4,4.3,18.2,16.1,114396.04296875,1580.14933586431
48302,10452,10452,36005021302,165924,0,Census Tract 213.02,New York,Bronx County,1999,4510,2508,2180,0,1712,287,181,328,328,0,328,0,0,2002,1635,0,1521,114,367,548,12.2,8.3,0.0,18.3,290211.9453125,2174.3813503012398
48303,10453,10453,36005021501,91954,0,Census Tract 215.01,New York,Bronx County,1594,3253,1898,1687,0,1429,165,93,211,183,0,183,0,28,1355,1160,0,1024,136,195,316,9.7,5.5,13.3,14.4,160862.875,2021.7016460194898
48304,10453,10453,36005021502,155720,0,Census Tract 215.02,New York,Bronx County,2081,4604,2584,2203,0,1827,254,122,381,358,0,309,49,23,2020,1727,0,1306,421,293,438,9.5,5.5,6.0,14.5,272404.6796875,2391.4857572958
48305,10460,10460,36005021601,164035,0,Census Tract 216.01,New York,Bronx County,1644,3333,1999,1710,13,1400,231,66,289,289,0,223,66,0,1334,1134,25,998,111,200,266,8.0,3.9,0.0,15.0,286860.56640625,2987.66113051467
48305,10462,10462,36005021601,164035,0,Census Tract 216.01,New York,Bronx County,1644,3333,1999,1710,13,1400,231,66,289,289,0,223,66,0,1334,1134,25,998,111,200,266,8.0,3.9,0.0,15.0,286860.56640625,2987.66113051467
48306,10462,10462,36005021602,165504,0,Census Tract 216.02,New York,Bronx County,2858,4708,3287,2949,14,2724,120,91,338,338,0,271,67,0,1421,1315,16,1161,138,106,197,4.2,3.1,0.0,7.5,289427.5625,2855.95993511888
48307,10452,10452,36005021700,161513,0,Census Tract 217,New York,Bronx County,1887,3548,2288,2034,0,1683,204,147,254,244,0,189,55,10,1260,962,0,771,191,298,455,12.8,7.2,3.9,23.7,282538.98046875,3055.0440670882203
48307,10453,10453,36005021700,161513,0,Census Tract 217,New York,Bronx County,1887,3548,2288,2034,0,1683,204,147,254,244,0,189,55,10,1260,962,0,771,191,298,455,12.8,7.2,3.9,23.7,282538.98046875,3055.0440670882203
48308,10460,10460,36005021800,320629,0,Census Tract 218,New York,Bronx County,3116,5295,3453,3205,0,2817,299,89,248,239,0,177,62,9,1842,1758,0,1485,273,84,182,3.4,2.8,3.6,4.6,560700.93359375,3744.27088127818
48309,10452,10452,36005021900,142939,0,Census Tract 219,New York,Bronx County,463,830,554,493,0,377,86,30,61,61,0,38,23,0,276,210,0,165,45,66,96,11.6,6.1,0.0,23.9,249979.61328125,2700.0869089314497
48310,10460,10460,36005022000,229296,0,Census Tract 220,New York,Bronx County,714,1568,955,815,0,556,158,101,140,111,0,97,14,29,613,415,0,371,44,198,328,20.9,12.4,20.7,32.3,401051.86328125,4305.2159456444
48310,10462,10462,36005022000,229296,0,Census Tract 220,New York,Bronx County,714,1568,955,815,0,556,158,101,140,111,0,97,14,29,613,415,0,371,44,198,328,20.9,12.4,20.7,32.3,401051.86328125,4305.2159456444
48311,10452,10452,36005022101,68119,0,Census Tract 221.01,New York,Bronx County,1299,2622,1517,1390,16,1177,106,91,127,127,0,127,0,0,1105,1008,0,853,155,97,188,7.2,6.5,0.0,8.8,119126.08203125,1560.41764331346
48312,10452,10452,36005022102,78293,0,Census Tract 221.02,New York,Bronx County,1654,3951,2302,1937,0,1423,231,283,365,347,14,286,47,18,1649,1248,0,1099,149,401,702,17.8,14.6,4.9,24.3,136915.796875,1573.48588193185
48313,10462,10462,36005022200,221189,0,Census Tract 222,New York,Bronx County,1524,2636,1730,1629,0,1454,70,105,101,66,0,66,0,35,906,715,0,608,107,191,331,12.6,6.4,34.7,21.1,386784.7109375,3910.2633038914705
48314,10452,10452,36005022300,92765,0,Census Tract 223,New York,Bronx County,1936,4133,2435,2164,0,1361,575,228,271,261,0,229,32,10,1698,1305,0,963,342,393,631,15.3,10.5,3.7,23.1,162238.88671875,1624.2044038620902
48315,10462,10462,36005022401,85053,0,Census Tract 224.01,New York,Bronx County,1223,2150,1476,1240,0,1016,207,17,236,236,0,160,76,0,674,534,0,479,55,140,157,7.3,1.4,0.0,20.8,148815.51171875,2033.4799993621302
48316,10462,10462,36005022403,124862,0,Census Tract 224.03,New York,Bronx County,1443,2723,1688,1466,0,1350,93,23,222,222,0,207,15,0,1035,837,13,769,55,198,221,8.1,1.6,0.0,19.1,218479.765625,2281.91034840173
48317,10462,10462,36005022404,92720,0,Census Tract 224.04,New York,Bronx County,2173,3615,2525,2340,7,1935,231,167,185,185,15,170,0,0,1090,871,35,745,91,219,386,10.7,7.1,0.0,20.1,162221.69140625,1620.9013194839401
48318,10456,10456,36005022500,180022,0,Census Tract 225,New York,Bronx County,2954,5628,3588,3184,14,2669,271,230,404,378,0,273,105,26,2040,1636,0,1368,268,404,660,11.7,7.2,6.4,19.8,314841.95703125,2403.07360080494
48318,10457,10457,36005022500,180022,0,Census Tract 225,New York,Bronx County,2954,5628,3588,3184,14,2669,271,230,404,378,0,273,105,26,2040,1636,0,1368,268,404,660,11.7,7.2,6.4,19.8,314841.95703125,2403.07360080494
48319,10453,10453,36005022701,114009,0,Census Tract 227.01,New York,Bronx County,2123,4003,2490,2241,0,1957,166,118,249,249,0,227,22,0,1513,1259,0,1183,76,254,372,9.3,5.3,0.0,16.8,199432.1171875,1994.3029192960603
48320,10452,10452,36005022702,50556,0,Census Tract 227.02,New York,Bronx County,641,1289,765,677,5,570,66,36,88,88,0,88,0,0,524,418,0,380,38,106,142,11.0,5.3,0.0,20.2,88430.1796875,1503.1920285728602
48321,10457,10457,36005022703,38660,0,Census Tract 227.03,New York,Bronx County,774,1331,880,809,0,758,16,35,71,71,0,60,11,0,451,382,0,351,31,69,104,7.8,4.3,0.0,15.3,67620.32421875,1035.79535970384
48322,10462,10462,36005022800,172197,0,Census Tract 228,New York,Bronx County,2738,4922,3264,2947,0,2493,245,209,317,317,0,317,0,0,1658,1487,16,1341,130,171,380,7.7,7.1,0.0,10.3,301274.23828125,2628.60600456876
48323,10457,10457,36005022901,121893,0,Census Tract 229.01,New York,Bronx County,1886,4111,2410,2205,10,1757,119,319,205,150,0,77,73,55,1701,1266,0,834,432,435,809,19.7,14.5,26.8,25.6,213220.37109375,1995.75302498394
48324,10457,10457,36005022902,91601,0,Census Tract 229.02,New York,Bronx County,1257,2501,1646,1375,0,1046,211,118,271,271,0,220,51,0,855,729,0,473,256,126,244,9.8,8.6,0.0,14.7,160217.5546875,1669.11507561661
48325,10462,10462,36005023000,159383,0,Census Tract 230,New York,Bronx County,1113,2006,1291,1188,0,913,200,75,103,82,0,72,10,21,715,629,0,506,123,86,182,9.1,6.3,20.4,12.0,278824.90625,2618.1642772166397
48326,10457,10457,36005023100,117143,0,Census Tract 231,New York,Bronx County,476,1055,591,492,0,420,56,16,99,99,0,91,8,0,464,389,0,299,90,75,91,8.6,3.3,0.0,16.2,204907.9296875,1890.98660486435
48327,10462,10462,36005023200,142706,0,Census Tract 232,New York,Bronx County,928,2037,1243,1090,0,794,134,162,153,153,0,124,29,0,794,644,0,572,72,150,312,15.3,14.9,0.0,18.9,249631.1484375,2141.8127439261802
48328,10453,10453,36005023301,119112,0,Census Tract 233.01,New York,Bronx County,1606,2981,1882,1671,0,1376,230,65,211,203,0,172,31,8,1099,903,0,843,60,196,269,9.0,3.9,3.8,17.8,208372.80078125,1817.17320693238
48329,10457,10457,36005023302,62577,0,Census Tract 233.02,New York,Bronx County,1506,2557,1708,1531,0,1348,158,25,177,154,0,132,22,23,849,776,0,551,225,73,121,4.7,1.6,13.0,8.6,109469.75,1445.03240385289
48330,10453,10453,36005023501,68200,0,Census Tract 235.01,New York,Bronx County,1251,2406,1500,1377,0,997,254,126,123,107,0,63,44,16,906,715,0,655,60,191,333,13.8,9.2,13.0,21.1,119316.22265625,1989.52475904483
48331,10457,10457,36005023502,96240,0,Census Tract 235.02,New York,Bronx County,1809,3555,2066,1862,0,1410,399,53,204,196,0,80,116,8,1489,1129,30,782,317,360,421,11.8,2.8,3.9,24.2,168369.23828125,2579.6106078747503
48332,10460,10460,36005023600,92075,0,Census Tract 236,New York,Bronx County,640,1364,840,730,0,533,107,90,110,85,0,85,0,25,524,384,0,304,80,140,255,18.7,12.3,22.7,26.7,161052.203125,2072.9362530888898
48332,10462,10462,36005023600,92075,0,Census Tract 236,New York,Bronx County,640,1364,840,730,0,533,107,90,110,85,0,85,0,25,524,384,0,304,80,140,255,18.7,12.3,22.7,26.7,161052.203125,2072.9362530888898
48333,10458,10458,36005023702,47892,0,Census Tract 237.02,New York,Bronx County,422,848,538,474,0,390,32,52,64,56,0,49,7,8,310,200,0,160,40,110,170,20.0,11.0,12.5,35.5,83811.703125,1374.7019530384
48334,10468,10468,36005023703,100593,0,Census Tract 237.03,New York,Bronx County,1947,3904,2560,2154,0,1779,168,207,406,396,0,311,85,10,1344,1086,0,927,159,258,475,12.2,9.6,2.5,19.2,176032.1484375,1998.25782535618
48335,10453,10453,36005023704,67466,0,Census Tract 237.04,New York,Bronx County,1283,2646,1557,1357,0,1145,138,74,200,200,0,161,39,0,1089,1009,0,852,157,80,154,5.8,5.5,0.0,7.3,118046.83203125,1460.6845300057598
48336,10462,10462,36005023800,339546,0,Census Tract 238,New York,Bronx County,1067,1723,1200,1082,0,971,96,15,118,100,0,100,0,18,523,482,5,399,78,41,74,4.3,1.4,15.3,7.8,593899.09375,3573.59730069056
48337,10453,10453,36005023900,178487,0,Census Tract 239,New York,Bronx County,2762,5520,3390,2976,0,2468,294,214,414,384,0,312,72,30,2130,1607,0,1480,127,523,767,13.9,7.2,7.2,24.6,312337.3671875,2946.55463136536
48337,10468,10468,36005023900,178487,0,Census Tract 239,New York,Bronx County,2762,5520,3390,2976,0,2468,294,214,414,384,0,312,72,30,2130,1607,0,1480,127,523,767,13.9,7.2,7.2,24.6,312337.3671875,2946.55463136536
48338,10460,10460,36005024000,239776,0,Census Tract 240,New York,Bronx County,1711,3253,2078,1893,21,1610,80,182,185,135,0,135,0,50,1175,1011,0,881,130,164,396,12.2,9.6,27.0,14.0,419369.15625,2895.9021476052803
48338,10462,10462,36005024000,239776,0,Census Tract 240,New York,Bronx County,1711,3253,2078,1893,21,1610,80,182,185,135,0,135,0,50,1175,1011,0,881,130,164,396,12.2,9.6,27.0,14.0,419369.15625,2895.9021476052803
48339,10453,10453,36005024100,134661,0,Census Tract 241,New York,Bronx County,2790,4753,3146,2896,0,2503,287,106,250,241,0,220,21,9,1607,1302,0,1128,174,305,420,8.8,3.7,3.6,19.0,235601.53515625,2152.48030100332
48340,10453,10453,36005024300,150432,0,Census Tract 243,New York,Bronx County,1871,4127,2164,2004,0,1504,367,133,160,118,0,118,0,42,1963,1441,0,1183,258,522,697,16.9,6.6,26.3,26.6,263187.703125,2503.57705407021
48341,10462,10462,36005024400,175718,0,Census Tract 244,New York,Bronx County,1080,1785,1217,1113,0,1014,66,33,104,91,0,84,7,13,568,449,0,433,16,119,165,9.2,3.0,12.5,21.0,307371.10546875,2613.4566970078895
48342,10453,10453,36005024501,113064,0,Census Tract 245.01,New York,Bronx County,1576,3387,1910,1682,0,1310,266,106,228,228,0,228,0,0,1477,1146,0,908,238,331,437,12.9,6.3,0.0,22.4,197815.40234375,1946.09432293855
48343,10453,10453,36005024502,100154,0,Census Tract 245.02,New York,Bronx County,1350,2838,1567,1444,0,1091,259,94,123,123,0,99,24,0,1271,1109,0,861,248,162,256,9.0,6.5,0.0,12.7,175238.234375,1691.2612275170002
48344,10462,10462,36005024600,152436,0,Census Tract 246,New York,Bronx County,963,1780,1165,1022,0,879,84,59,143,128,0,107,21,15,615,514,13,448,53,101,175,9.8,5.8,10.5,16.4,266686.13671875,3029.52192680403
48345,10453,10453,36005024700,145941,2672,Census Tract 247,New York,Bronx County,893,1634,991,928,0,753,140,35,63,63,0,45,18,0,643,552,0,406,146,91,126,7.7,3.8,0.0,14.2,246891.42578125,2881.7529929255998
48346,10461,10461,36005024800,277912,0,Census Tract 248,New York,Bronx County,1494,2409,1678,1515,0,1427,67,21,163,163,0,130,33,0,731,577,0,557,20,154,175,7.3,1.4,0.0,21.1,486259.359375,3018.52154335013
48346,10462,10462,36005024800,277912,0,Census Tract 248,New York,Bronx County,1494,2409,1678,1515,0,1427,67,21,163,163,0,130,33,0,731,577,0,557,20,154,175,7.3,1.4,0.0,21.1,486259.359375,3018.52154335013
48347,10453,10453,36005024900,173728,0,Census Tract 249,New York,Bronx County,0,0,0,0,0,0,0,0,0,0,0,0,0,0,0,0,0,0,0,0,0,,,,,303991.94921875,2656.35743493967
48348,10461,10461,36005025000,181709,0,Census Tract 250,New York,Bronx County,1102,1997,1286,1209,0,1011,91,107,77,77,0,77,0,0,711,494,0,462,32,217,324,16.2,8.9,0.0,30.5,317903.75,2813.4727736122304
48348,10462,10462,36005025000,181709,0,Census Tract 250,New York,Bronx County,1102,1997,1286,1209,0,1011,91,107,77,77,0,77,0,0,711,494,0,462,32,217,324,16.2,8.9,0.0,30.5,317903.75,2813.4727736122304
48349,10453,10453,36005025100,209329,0,Census Tract 251,New York,Bronx County,2584,4831,2882,2689,14,2127,443,105,193,193,0,193,0,0,1949,1687,15,1326,346,262,367,7.6,3.9,0.0,13.4,366273.5859375,2539.31883045841
48350,10461,10461,36005025200,190715,0,Census Tract 252,New York,Bronx County,1265,2262,1394,1299,0,1179,86,34,95,78,0,71,7,17,868,686,0,617,69,182,233,10.3,2.6,17.9,21.0,333611.203125,2801.0547365324296
48350,10462,10462,36005025200,190715,0,Census Tract 252,New York,Bronx County,1265,2262,1394,1299,0,1179,86,34,95,78,0,71,7,17,868,686,0,617,69,182,233,10.3,2.6,17.9,21.0,333611.203125,2801.0547365324296
48351,10468,10468,36005025300,124458,0,Census Tract 253,New York,Bronx County,2502,4377,2878,2624,0,2193,309,122,254,238,0,215,23,16,1499,1145,0,1088,57,354,492,11.2,4.6,6.3,23.6,217797.19921875,2188.23106905655
48352,10461,10461,36005025400,169924,0,Census Tract 254,New York,Bronx County,887,1761,964,893,9,831,47,6,71,71,0,45,26,0,797,650,4,611,35,147,153,8.7,0.7,0.0,18.4,297255.28515625,2583.32103041103
48353,10453,10453,36005025500,168637,0,Census Tract 255,New York,Bronx County,3123,5264,3600,3203,0,2619,504,80,397,319,0,247,72,78,1664,1345,0,1084,261,319,477,9.1,2.5,19.6,19.2,295110.84375,2648.23921048102
48353,10468,10468,36005025500,168637,0,Census Tract 255,New York,Bronx County,3123,5264,3600,3203,0,2619,504,80,397,319,0,247,72,78,1664,1345,0,1084,261,319,477,9.1,2.5,19.6,19.2,295110.84375,2648.23921048102
48354,10461,10461,36005025600,189286,0,Census Tract 256,New York,Bronx County,701,1280,866,717,0,631,70,16,149,149,0,135,14,0,414,384,0,303,81,30,46,3.6,2.2,0.0,7.2,331083.46875,2857.83279625933
48354,10462,10462,36005025600,189286,0,Census Tract 256,New York,Bronx County,701,1280,866,717,0,631,70,16,149,149,0,135,14,0,414,384,0,303,81,30,46,3.6,2.2,0.0,7.2,331083.46875,2857.83279625933
48355,10468,10468,36005025700,161279,17989,Census Tract 257,New York,Bronx County,1265,1691,1334,1265,0,1180,85,0,69,69,0,29,40,0,357,324,0,287,37,33,33,2.0,0.0,0.0,9.2,282234.25390625,3636.2245646215297
48356,10468,10468,36005026100,174717,0,Census Tract 261,New York,Bronx County,921,1650,1014,982,0,830,91,61,32,32,0,32,0,0,636,500,0,460,40,136,197,11.9,6.2,0.0,21.4,305806.44921875,2599.37739019308
48357,10468,10468,36005026300,158787,0,Census Tract 263,New York,Bronx County,2033,4373,2439,2226,0,2013,20,193,213,130,0,105,25,83,1934,1508,0,1354,154,426,702,16.1,8.7,39.0,22.0,277909.83984375,3015.6721502537202
48358,10461,10461,36005026400,426510,0,Census Tract 264,New York,Bronx County,2277,4218,2823,2614,0,2101,176,337,209,209,0,209,0,0,1395,1102,0,1102,0,293,630,14.9,12.9,0.0,21.0,745970.69921875,3868.58163117781
48359,10468,10468,36005026500,202137,0,Census Tract 265,New York,Bronx County,3373,5571,4057,3560,0,3105,268,187,497,497,0,469,28,0,1514,1225,0,1162,63,289,476,8.5,5.3,0.0,19.1,353793.9609375,3025.4516084564398
48360,10461,10461,36005026601,170250,0,Census Tract 266.01,New York,Bronx County,1468,2685,1622,1570,0,1373,95,102,52,52,0,52,0,0,1063,770,0,701,69,293,395,14.7,6.5,0.0,27.6,297813.921875,2566.29364478414
48361,10461,10461,36005026602,303397,0,Census Tract 266.02,New York,Bronx County,2187,4220,2515,2275,0,2130,57,88,240,240,0,228,12,0,1705,1229,0,1137,92,476,564,13.4,3.9,0.0,27.9,530704.90234375,3282.52625886627
48362,10468,10468,36005026701,69160,0,Census Tract 267.01,New York,Bronx County,2085,3196,2311,2098,0,2026,59,13,213,195,0,179,16,18,885,833,0,764,69,52,83,2.6,0.6,8.5,5.9,121060.6015625,1455.08201656251
48363,10468,10468,36005026702,166368,0,Census Tract 267.02,New York,Bronx County,3173,5335,3640,3289,0,2890,283,116,351,296,0,199,97,55,1695,1393,19,1197,177,302,473,8.9,3.5,15.7,17.8,291241.765625,2502.149814886
48364,10463,10463,36005026900,384055,27111,Census Tract 269,New York,Bronx County,1719,2591,1872,1730,0,1678,41,11,142,142,0,111,31,0,719,608,0,509,99,111,122,4.7,0.6,0.0,15.4,672230.40625,4671.149365162511
48364,10468,10468,36005026900,384055,27111,Census Tract 269,New York,Bronx County,1719,2591,1872,1730,0,1678,41,11,142,142,0,111,31,0,719,608,0,509,99,111,122,4.7,0.6,0.0,15.4,672230.40625,4671.149365162511
48365,10463,10463,36005027300,203341,0,Census Tract 273,New York,Bronx County,3319,5893,3881,3494,0,3254,65,175,387,369,0,369,0,18,2012,1568,0,1519,49,444,637,10.8,5.0,4.7,22.1,355985.59375,3158.0434249242403
48365,10468,10468,36005027300,203341,0,Census Tract 273,New York,Bronx County,3319,5893,3881,3494,0,3254,65,175,387,369,0,369,0,18,2012,1568,0,1519,49,444,637,10.8,5.0,4.7,22.1,355985.59375,3158.0434249242403
48366,10465,10465,36005027401,701116,0,Census Tract 274.01,New York,Bronx County,2154,4063,2381,2290,21,2132,1,136,91,91,0,91,0,0,1682,1455,0,1428,27,227,363,8.9,5.9,0.0,13.5,1226198.29296875,5581.706362336589
48367,10465,10465,36005027402,504814,706508,Census Tract 274.02,New York,Bronx County,1692,2833,1756,1711,32,1563,97,19,45,45,0,37,8,0,1077,945,0,859,86,132,151,5.3,1.1,0.0,12.3,851210.87890625,5416.59165281035
48368,10461,10461,36005027600,1526823,782519,Census Tract 276,New York,Bronx County,0,4,0,0,0,0,0,0,0,0,0,0,0,0,4,0,0,0,0,4,4,100.0,,,100.0,2671384.44140625,10076.0336986564
48368,10475,10475,36005027600,1526823,782519,Census Tract 276,New York,Bronx County,0,4,0,0,0,0,0,0,0,0,0,0,0,0,4,0,0,0,0,4,4,100.0,,,100.0,2671384.44140625,10076.0336986564
48369,10463,10463,36005027700,176710,0,Census Tract 277,New York,Bronx County,1920,3543,2221,2043,0,1878,42,123,178,178,0,178,0,0,1322,908,0,882,26,414,537,15.2,6.0,0.0,31.3,309403.8828125,2852.28877085545
48370,10463,10463,36005027900,275640,0,Census Tract 279,New York,Bronx County,3532,5214,3745,3551,0,3279,253,19,194,181,0,181,0,13,1469,1276,0,1256,20,193,225,4.3,0.5,6.7,13.1,482682.96484375,3683.38824717541
48371,10463,10463,36005028100,129158,0,Census Tract 281,New York,Bronx County,1977,3436,2290,2078,0,1942,35,101,212,202,0,202,0,10,1146,1020,0,967,53,126,237,6.9,4.9,4.7,11.0,226179.8046875,2227.83863677433
48372,10463,10463,36005028300,227445,0,Census Tract 283,New York,Bronx County,921,2047,1116,944,0,821,100,23,172,159,0,159,0,13,931,553,0,495,58,378,414,20.2,2.4,7.6,40.6,398263.9453125,4765.4525077485105
48373,10461,10461,36005028400,1124691,0,Census Tract 284,New York,Bronx County,67,76,72,67,0,67,0,0,5,5,0,5,0,0,4,0,0,0,0,4,4,5.3,0.0,0.0,100.0,1967524.51953125,8305.46829650925
48373,10469,10469,36005028400,1124691,0,Census Tract 284,New York,Bronx County,67,76,72,67,0,67,0,0,5,5,0,5,0,0,4,0,0,0,0,4,4,5.3,0.0,0.0,100.0,1967524.51953125,8305.46829650925
48374,10463,10463,36005028500,263658,0,Census Tract 285,New York,Bronx County,1864,3079,2082,1926,65,1713,86,62,156,156,0,156,0,0,997,790,61,659,70,207,269,8.7,3.2,0.0,20.8,461752.46875,4345.950539854211
48374,10471,10471,36005028500,263658,0,Census Tract 285,New York,Bronx County,1864,3079,2082,1926,65,1713,86,62,156,156,0,156,0,0,997,790,61,659,70,207,269,8.7,3.2,0.0,20.8,461752.46875,4345.950539854211
48375,10461,10461,36005028600,200018,0,Census Tract 286,New York,Bronx County,537,887,597,552,0,530,7,15,45,45,0,45,0,0,290,224,0,218,6,66,81,9.1,2.7,0.0,22.8,349909.18359375,2446.6697182644198
48376,10463,10463,36005028700,155302,0,Census Tract 287,New York,Bronx County,1444,2489,1680,1456,0,1400,44,12,224,204,0,204,0,20,809,567,0,507,60,242,274,11.0,0.8,8.9,29.9,271951.73046875,2115.03050185371
48377,10461,10461,36005028800,336192,0,Census Tract 288,New York,Bronx County,1708,2729,1849,1774,0,1598,110,66,75,75,0,75,0,0,880,726,0,693,33,154,220,8.1,3.7,0.0,17.5,588215.28515625,3308.46033993968
48378,10463,10463,36005028900,201144,0,Census Tract 289,New York,Bronx County,2114,3612,2444,2297,46,2050,18,183,147,147,11,136,0,0,1168,770,0,707,63,398,581,16.1,8.0,0.0,34.1,352197.09375,2465.60204435971
48379,10463,10463,36005029301,286791,733019,Census Tract 293.01,New York,Bronx County,857,1447,913,863,0,815,42,6,50,50,0,50,0,0,534,501,0,458,43,33,39,2.7,0.7,0.0,6.2,502199.64453125,3522.7339039313792
48380,10463,10463,36005029302,425237,0,Census Tract 293.02,New York,Bronx County,2888,4637,2993,2888,40,2742,106,0,105,105,0,105,0,0,1644,1475,17,1376,82,169,169,3.6,0.0,0.0,10.3,743515.09765625,4870.03953542935
48381,10463,10463,36005029500,236468,0,Census Tract 295,New York,Bronx County,2484,3865,2725,2609,0,2430,54,125,116,116,0,116,0,0,1140,884,0,850,34,256,381,9.9,4.8,0.0,22.5,414115.390625,3688.4316094050896
48382,10461,10461,36005029600,723313,0,Census Tract 296,New York,Bronx County,779,1301,880,824,0,731,48,45,56,56,0,56,0,0,421,356,0,289,67,65,110,8.5,5.5,0.0,15.4,1265587.90625,7064.122533504879
48383,10463,10463,36005029700,232730,0,Census Tract 297,New York,Bronx County,1598,2744,1781,1672,0,1579,19,74,109,109,0,109,0,0,963,730,17,694,19,233,307,11.2,4.4,0.0,24.2,407568.0625,3347.2334763094104
48384,10461,10461,36005030000,415698,0,Census Tract 300,New York,Bronx County,3160,4827,3451,3277,0,2814,346,117,174,174,0,165,9,0,1376,1002,0,858,144,374,491,10.2,3.6,0.0,27.2,727278.77734375,3448.20579623426
48385,10463,10463,36005030100,146000,0,Census Tract 301,New York,Bronx County,533,905,533,533,0,500,33,0,0,0,0,0,0,0,372,262,5,193,64,110,110,12.2,0.0,,29.6,255671.0078125,2041.8291797053896
48386,10475,10475,36005030200,433614,126090,Census Tract 302,New York,Bronx County,3652,7904,4455,4073,0,3515,137,421,382,342,0,342,0,40,3449,2678,53,2379,246,771,1232,15.6,10.3,10.5,22.4,758878.5078125,4635.008335305821
48387,10463,10463,36005030701,396736,0,Census Tract 307.01,New York,Bronx County,2659,4486,2888,2697,0,2619,40,38,191,191,0,147,44,0,1598,1356,0,1210,146,242,280,6.2,1.4,0.0,15.1,694959.921875,5529.606088330849
48387,10471,10471,36005030701,396736,0,Census Tract 307.01,New York,Bronx County,2659,4486,2888,2697,0,2619,40,38,191,191,0,147,44,0,1598,1356,0,1210,146,242,280,6.2,1.4,0.0,15.1,694959.921875,5529.606088330849
48388,10463,10463,36005030900,1365850,2151862,Census Tract 309,New York,Bronx County,1249,2340,1345,1259,10,1207,32,10,86,86,0,86,0,0,995,741,10,672,59,254,264,11.3,0.8,0.0,25.5,2392847.2265625,10012.9470652454
48388,10471,10471,36005030900,1365850,2151862,Census Tract 309,New York,Bronx County,1249,2340,1345,1259,10,1207,32,10,86,86,0,86,0,0,995,741,10,672,59,254,264,11.3,0.8,0.0,25.5,2392847.2265625,10012.9470652454
48389,10469,10469,36005031000,634013,0,Census Tract 310,New York,Bronx County,1928,3362,2046,1984,0,1886,42,56,62,62,0,62,0,0,1316,1174,0,1149,25,142,198,5.9,2.8,0.0,10.8,1109538.3671875,4324.85077751747
48390,10469,10469,36005031200,202061,0,Census Tract 312,New York,Bronx County,778,1299,851,790,7,742,29,12,61,61,0,61,0,0,448,370,5,345,20,78,90,6.9,1.5,0.0,17.4,353617.4453125,2899.41803610824
48391,10469,10469,36005031400,211194,0,Census Tract 314,New York,Bronx County,1009,1681,1159,1077,17,956,36,68,82,82,12,70,0,0,522,435,8,427,0,87,155,9.2,6.3,0.0,16.7,369592.77734375,2917.2323373669105
48392,10469,10469,36005031600,177170,0,Census Tract 316,New York,Bronx County,983,1525,1065,1015,14,933,36,32,50,43,0,43,0,7,460,417,20,354,43,43,82,5.4,3.2,14.0,9.3,310055.2734375,2553.31909217291
48393,10469,10469,36005031800,178366,0,Census Tract 318,New York,Bronx County,877,1635,1023,890,6,789,82,13,133,133,0,133,0,0,612,456,6,400,50,156,169,10.3,1.5,0.0,25.5,312149.40625,2924.9679050745503
48394,10471,10471,36005031900,213170,201583,Census Tract 319,New York,Bronx County,0,0,0,0,0,0,0,0,0,0,0,0,0,0,0,0,0,0,0,0,0,,,,,373626.77734375,2893.01941946235
48395,10471,10471,36005032300,561181,0,Census Tract 323,New York,Bronx County,2131,3814,2393,2243,0,1921,210,112,150,136,0,114,22,14,1421,1213,39,1082,92,208,334,8.8,5.0,9.3,14.6,983375.8515625,4526.890285425539
48396,10469,10469,36005032400,268373,0,Census Tract 324,New York,Bronx County,1520,3090,1856,1554,0,1361,159,34,302,302,0,302,0,0,1234,957,24,639,294,277,311,10.1,2.2,0.0,22.4,469658.9140625,3076.4684147261
48397,10469,10469,36005032600,331185,0,Census Tract 326,New York,Bronx County,1685,3097,2006,1832,0,1642,43,147,174,134,0,134,0,40,1091,981,0,770,211,110,297,9.6,8.0,23.0,10.1,579593.23828125,3548.98077622608
48398,10467,10467,36005032800,204657,0,Census Tract 328,New York,Bronx County,1290,2826,1632,1443,13,1201,76,153,189,161,0,144,17,28,1194,807,13,700,94,387,568,20.1,10.6,14.8,32.4,358157.28515625,2874.1431559551
48398,10469,10469,36005032800,204657,0,Census Tract 328,New York,Bronx County,1290,2826,1632,1443,13,1201,76,153,189,161,0,144,17,28,1194,807,13,700,94,387,568,20.1,10.6,14.8,32.4,358157.28515625,2874.1431559551
48399,10467,10467,36005033000,206129,0,Census Tract 330,New York,Bronx County,2461,4651,3040,2593,44,2222,195,132,447,348,0,348,0,99,1611,1259,49,1080,130,352,583,12.5,5.1,22.1,21.8,360731.2734375,2883.26153750116
48400,10467,10467,36005033201,114036,0,Census Tract 332.01,New York,Bronx County,2244,3983,2636,2363,11,2071,162,119,273,268,10,258,0,5,1347,981,9,839,133,366,490,12.3,5.0,1.8,27.2,199554.91796875,1871.7243897025
48401,10467,10467,36005033202,115204,0,Census Tract 332.02,New York,Bronx County,1378,3066,1592,1468,0,1282,96,90,124,124,0,119,5,0,1474,1106,0,946,160,368,458,14.9,6.1,0.0,25.0,201621.7890625,1869.1951273653897
48402,10458,10458,36005033400,3044513,62113,Census Tract 334,New York,Bronx County,34,63,39,34,0,34,0,0,5,5,0,5,0,0,24,24,0,24,0,0,0,0.0,0.0,0.0,0.0,5436072.7265625,13010.5441883584
48402,10460,10460,36005033400,3044513,62113,Census Tract 334,New York,Bronx County,34,63,39,34,0,34,0,0,5,5,0,5,0,0,24,24,0,24,0,0,0,0.0,0.0,0.0,0.0,5436072.7265625,13010.5441883584
48402,10462,10462,36005033400,3044513,62113,Census Tract 334,New York,Bronx County,34,63,39,34,0,34,0,0,5,5,0,5,0,0,24,24,0,24,0,0,0,0.0,0.0,0.0,0.0,5436072.7265625,13010.5441883584
48402,10469,10469,36005033400,3044513,62113,Census Tract 334,New York,Bronx County,34,63,39,34,0,34,0,0,5,5,0,5,0,0,24,24,0,24,0,0,0,0.0,0.0,0.0,0.0,5436072.7265625,13010.5441883584
48403,10463,10463,36005033500,696563,0,Census Tract 335,New York,Bronx County,746,1213,796,763,0,730,16,17,33,33,0,33,0,0,417,344,6,327,11,73,90,7.4,2.2,0.0,17.5,1220203.23046875,5772.865522833821
48403,10471,10471,36005033500,696563,0,Census Tract 335,New York,Bronx County,746,1213,796,763,0,730,16,17,33,33,0,33,0,0,417,344,6,327,11,73,90,7.4,2.2,0.0,17.5,1220203.23046875,5772.865522833821
48404,10467,10467,36005033600,184395,0,Census Tract 336,New York,Bronx County,2426,5140,2919,2508,0,1990,436,82,411,383,0,383,0,28,2221,2000,23,1642,335,221,331,6.4,3.3,6.8,10.0,322761.71875,2510.23736211757
48405,10471,10471,36005033700,424038,0,Census Tract 337,New York,Bronx County,1021,1893,1109,1039,6,966,49,18,70,70,0,70,0,0,784,740,0,620,120,44,62,3.3,1.7,0.0,5.6,743075.12890625,4885.83205108475
48406,10467,10467,36005033800,161380,0,Census Tract 338,New York,Bronx County,1797,3337,2180,1892,10,1635,152,95,288,276,0,157,119,12,1157,954,0,878,76,203,310,9.3,5.0,4.2,17.5,282479.6796875,2399.2057991888
48407,10467,10467,36005034000,158331,0,Census Tract 340,New York,Bronx County,2258,4055,2749,2423,5,1867,386,165,326,292,0,177,115,34,1306,993,6,840,147,313,512,12.6,6.8,10.4,24.0,277142.3125,2365.08891213939
48407,10469,10469,36005034000,158331,0,Census Tract 340,New York,Bronx County,2258,4055,2749,2423,5,1867,386,165,326,292,0,177,115,34,1306,993,6,840,147,313,512,12.6,6.8,10.4,24.0,277142.3125,2365.08891213939
48408,10469,10469,36005034200,156834,0,Census Tract 342,New York,Bronx County,826,1576,939,869,0,706,120,43,70,53,0,53,0,17,637,516,0,398,118,121,181,11.5,4.9,24.3,19.0,274518.13671875,2348.03003743226
48409,10471,10471,36005034300,121723,0,Census Tract 343,New York,Bronx County,753,1088,806,753,0,695,58,0,53,53,0,53,0,0,282,252,0,252,0,30,30,2.8,0.0,0.0,10.6,213326.87890625,2022.09393529525
48410,10469,10469,36005034400,157012,0,Census Tract 344,New York,Bronx County,1009,1800,1061,1037,0,1009,0,28,24,24,0,24,0,0,739,653,0,602,51,86,114,6.3,2.7,0.0,11.6,274833.18359375,2350.6789947318202
48411,10471,10471,36005034500,274627,0,Census Tract 345,New York,Bronx County,1383,2626,1688,1501,0,1329,54,118,187,180,0,169,11,7,938,756,0,675,81,182,307,11.7,7.9,3.7,19.4,481219.0859375,3130.0192104483503
48412,10469,10469,36005034800,437468,0,Census Tract 348,New York,Bronx County,2715,4889,2866,2752,0,2265,450,37,114,114,0,114,0,0,2023,1822,0,1630,192,201,238,4.9,1.3,0.0,9.9,765758.98046875,4035.8762326103706
48413,10469,10469,36005035000,191626,0,Census Tract 350,New York,Bronx County,1187,1691,1277,1231,33,868,286,44,46,46,0,46,0,0,414,368,0,274,94,46,90,5.3,3.6,0.0,11.1,335423.4609375,2570.9571918821
48414,10471,10471,36005035100,580468,0,Census Tract 351,New York,Bronx County,1462,2220,1525,1462,0,1197,265,0,63,63,0,63,0,0,695,642,0,384,258,53,53,2.4,0.0,0.0,7.6,1016859.00390625,5231.262705314421
48415,10469,10469,36005035600,397359,0,Census Tract 356,New York,Bronx County,1063,1824,1144,1081,0,1053,10,18,63,63,0,63,0,0,680,561,25,516,20,119,137,7.5,1.7,0.0,17.5,695501.28125,4919.89559643627
48416,10469,10469,36005035800,651471,0,Census Tract 358,New York,Bronx County,3906,6933,4506,4011,0,3635,271,105,495,495,0,470,25,0,2427,2227,0,2028,199,200,305,4.4,2.6,0.0,8.2,1140515.37890625,4510.86856488099
48417,10460,10460,36005035900,134331,0,Census Tract 359,New York,Bronx County,582,1490,728,614,0,570,12,32,114,106,0,94,12,8,762,583,0,544,39,179,219,14.7,5.2,7.0,23.5,234935.6953125,2266.77848904145
48418,10469,10469,36005036000,266176,0,Census Tract 360,New York,Bronx County,1333,2362,1530,1400,28,1247,58,67,130,124,0,124,0,6,832,705,7,671,27,127,200,8.5,4.8,4.6,15.3,465889.6328125,3073.2937856186604
48419,10460,10460,36005036100,164834,0,Census Tract 361,New York,Bronx County,1860,4438,2347,1877,0,1394,466,17,470,470,0,470,0,0,2091,1617,0,945,672,474,491,11.1,0.9,0.0,22.7,288297.578125,2301.70920109444
48420,10460,10460,36005036300,221467,0,Census Tract 363,New York,Bronx County,2683,5843,3572,2821,0,2052,631,138,751,719,0,392,327,32,2271,1865,20,1214,631,406,576,9.9,4.9,4.3,17.9,387373.234375,2615.80425739506
48421,10469,10469,36005036400,203683,0,Census Tract 364,New York,Bronx County,1206,2118,1327,1264,0,1068,138,58,63,63,0,41,22,0,791,698,22,584,92,93,151,7.1,4.6,0.0,11.8,356580.69140625,2748.47141455265
48422,10460,10460,36005036501,95827,0,Census Tract 365.01,New York,Bronx County,1288,2921,1648,1335,0,1141,147,47,313,313,0,280,33,0,1273,966,0,779,187,307,354,12.1,3.5,0.0,24.1,167616.66796875,2426.53535146454
48423,10460,10460,36005036502,97659,0,Census Tract 365.02,New York,Bronx County,948,1699,1077,1004,0,797,151,56,73,73,0,73,0,0,622,527,0,481,46,95,151,8.9,5.6,0.0,15.3,170807.77734375,1754.08672069163
48424,10460,10460,36005036700,93063,0,Census Tract 367,New York,Bronx County,764,1377,916,835,0,613,151,71,81,48,0,39,9,33,461,396,0,366,30,65,169,12.3,8.5,40.7,14.1,162760.109375,1835.41909042663
48425,10469,10469,36005036800,169530,0,Census Tract 368,New York,Bronx County,835,1516,990,899,0,723,112,64,91,74,0,56,18,17,526,419,0,419,0,107,188,12.4,7.1,18.7,20.3,296804.546875,2453.6517941234197
48426,10457,10457,36005036901,98732,0,Census Tract 369.01,New York,Bronx County,675,1573,830,716,0,506,169,41,114,106,6,63,37,8,743,508,0,408,100,235,284,18.1,5.7,7.0,31.6,172698.00390625,1754.7857421339802
48427,10457,10457,36005036902,62406,0,Census Tract 369.02,New York,Bronx County,569,1562,756,596,0,468,101,27,160,153,0,137,16,7,806,666,0,505,161,140,174,11.1,4.5,4.4,17.4,109151.58984375,1397.40484526833
48428,10469,10469,36005037000,158885,0,Census Tract 370,New York,Bronx County,1107,2048,1353,1254,0,918,189,147,99,99,0,84,15,0,695,582,0,434,148,113,260,12.7,11.7,0.0,16.3,278152.55078125,2079.88315275307
48429,10457,10457,36005037100,198178,0,Census Tract 371,New York,Bronx County,1564,3375,1825,1706,0,1435,129,142,119,119,0,94,25,0,1550,1192,0,903,289,358,500,14.8,8.3,0.0,23.1,346668.91796875,2551.94654321193
48429,10460,10460,36005037100,198178,0,Census Tract 371,New York,Bronx County,1564,3375,1825,1706,0,1435,129,142,119,119,0,94,25,0,1550,1192,0,903,289,358,500,14.8,8.3,0.0,23.1,346668.91796875,2551.94654321193
48430,10467,10467,36005037200,186530,0,Census Tract 372,New York,Bronx County,1093,1859,1262,1153,0,1041,52,60,109,109,0,109,0,0,597,507,0,481,26,90,150,8.1,5.2,0.0,15.1,326552.1796875,2528.83777569448
48431,10457,10457,36005037300,173453,0,Census Tract 373,New York,Bronx County,1757,3981,2220,1969,0,1357,400,212,251,230,0,208,22,21,1761,1484,0,970,514,277,510,12.8,10.8,8.4,15.7,303429.50390625,2910.26781742682
48432,10467,10467,36005037400,167070,0,Census Tract 374,New York,Bronx County,1402,3002,1796,1604,0,1088,314,202,192,137,0,100,37,55,1206,949,0,705,244,257,514,17.1,12.6,28.6,21.3,292494.7734375,2659.03437633378
48433,10457,10457,36005037504,239719,0,Census Tract 375.04,New York,Bronx County,1055,2374,1287,1130,0,880,175,75,157,157,0,91,66,0,1087,871,0,573,298,216,291,12.3,6.6,0.0,19.9,419375.80078125,3563.95717111425
48434,10467,10467,36005037600,124765,0,Census Tract 376,New York,Bronx County,949,1771,1149,972,0,833,116,23,177,163,0,139,24,14,622,530,0,451,79,92,129,7.3,2.4,7.9,14.8,218428.109375,2339.92361796832
48435,10467,10467,36005037800,131851,0,Census Tract 378,New York,Bronx County,1189,2262,1416,1250,0,930,259,61,166,166,0,166,0,0,846,685,0,568,117,161,222,9.8,4.9,0.0,19.0,230864.69921875,2077.63497629223
48436,10457,10457,36005037900,191332,0,Census Tract 379,New York,Bronx County,1466,3265,1971,1668,0,1109,357,202,303,257,0,170,87,46,1294,1038,0,794,244,256,504,15.4,12.1,15.2,19.8,334735.640625,3383.76580688218
48437,10467,10467,36005038000,213585,0,Census Tract 380,New York,Bronx County,2025,3946,2425,2090,0,1748,277,65,335,283,0,184,99,52,1521,1292,0,1140,152,229,346,8.8,3.1,15.5,15.1,373964.375,2456.57291329353
48438,10457,10457,36005038100,151507,0,Census Tract 381,New York,Bronx County,3064,5036,3430,3157,0,2400,664,93,273,262,0,262,0,11,1606,1388,0,1115,273,218,322,6.4,2.9,4.0,13.6,265066.13671875,2738.74957096261
48439,10469,10469,36005038200,157168,0,Census Tract 382,New York,Bronx County,1112,2145,1343,1155,0,887,225,43,188,162,0,98,64,26,802,681,0,461,220,121,190,8.9,3.7,13.8,15.1,275178.0,3179.36025173335
48440,10457,10457,36005038301,94777,0,Census Tract 383.01,New York,Bronx County,2021,3702,2457,2179,0,1682,339,158,278,278,0,252,26,0,1245,1103,0,857,246,142,300,8.1,7.3,0.0,11.4,165839.625,1669.51170344957
48440,10458,10458,36005038301,94777,0,Census Tract 383.01,New York,Bronx County,2021,3702,2457,2179,0,1682,339,158,278,278,0,252,26,0,1245,1103,0,857,246,142,300,8.1,7.3,0.0,11.4,165839.625,1669.51170344957
48441,10457,10457,36005038302,145689,0,Census Tract 383.02,New York,Bronx County,1751,4176,2305,1807,0,1375,376,56,498,498,0,431,67,0,1871,1482,0,1229,253,389,445,10.7,3.1,0.0,20.8,254926.7265625,3250.90183036594
48441,10458,10458,36005038302,145689,0,Census Tract 383.02,New York,Bronx County,1751,4176,2305,1807,0,1375,376,56,498,498,0,431,67,0,1871,1482,0,1229,253,389,445,10.7,3.1,0.0,20.8,254926.7265625,3250.90183036594
48442,10457,10457,36005038500,189195,0,Census Tract 385,New York,Bronx County,1387,3384,1758,1529,0,1167,220,142,229,229,0,196,33,0,1626,1298,0,1067,231,328,470,13.9,9.3,0.0,20.2,331041.88671875,3076.91092219261
48442,10458,10458,36005038500,189195,0,Census Tract 385,New York,Bronx County,1387,3384,1758,1529,0,1167,220,142,229,229,0,196,33,0,1626,1298,0,1067,231,328,470,13.9,9.3,0.0,20.2,331041.88671875,3076.91092219261
48443,10466,10466,36005038600,409291,0,Census Tract 386,New York,Bronx County,3821,6950,4204,3996,0,3248,573,175,208,208,0,188,20,0,2746,2225,0,2041,184,521,696,10.0,4.4,0.0,19.0,716663.57421875,3921.2364530766204
48443,10469,10469,36005038600,409291,0,Census Tract 386,New York,Bronx County,3821,6950,4204,3996,0,3248,573,175,208,208,0,188,20,0,2746,2225,0,2041,184,521,696,10.0,4.4,0.0,19.0,716663.57421875,3921.2364530766204
48444,10458,10458,36005038700,188318,0,Census Tract 387,New York,Bronx County,1354,2828,1911,1420,0,1157,197,66,491,451,0,416,35,40,917,780,0,725,55,137,243,8.6,4.6,8.1,14.9,329530.39453125,2503.08255280814
48445,10469,10469,36005038800,148659,0,Census Tract 388,New York,Bronx County,1067,2205,1483,1295,0,931,136,228,188,166,0,150,16,22,722,564,0,523,41,158,408,18.5,17.6,11.7,21.9,260297.70703125,2074.41119684756
48446,10458,10458,36005038900,170340,0,Census Tract 389,New York,Bronx County,2028,3976,2482,2142,0,1820,208,114,340,321,0,276,45,19,1494,1133,0,910,223,361,494,12.4,5.3,5.6,24.2,298053.1328125,2183.20546295328
48447,10467,10467,36005039000,181646,0,Census Tract 390,New York,Bronx County,1180,2297,1585,1249,0,1023,157,69,336,270,0,239,31,66,712,576,0,543,33,136,271,11.8,5.5,19.6,19.1,318074.55859375,2316.66674489031
48448,10457,10457,36005039100,205723,0,Census Tract 391,New York,Bronx County,2782,5347,3244,2975,0,2445,337,193,269,217,0,162,55,52,2103,1856,0,1502,354,247,492,9.2,6.5,19.3,11.7,359933.00390625,2372.98755913608
48448,10458,10458,36005039100,205723,0,Census Tract 391,New York,Bronx County,2782,5347,3244,2975,0,2445,337,193,269,217,0,162,55,52,2103,1856,0,1502,354,247,492,9.2,6.5,19.3,11.7,359933.00390625,2372.98755913608
48449,10467,10467,36005039200,96134,0,Census Tract 392,New York,Bronx County,770,1319,957,839,0,697,73,69,118,79,0,59,20,39,362,304,0,289,15,58,166,12.6,8.2,33.1,16.0,168344.61328125,1651.60928788278
48450,10457,10457,36005039300,181726,0,Census Tract 393,New York,Bronx County,2277,6382,3090,2445,32,1649,596,168,645,607,0,353,254,38,3292,2527,22,1833,672,765,971,15.2,6.9,5.9,23.2,317938.2578125,3110.30728273144
48450,10458,10458,36005039300,181726,0,Census Tract 393,New York,Bronx County,2277,6382,3090,2445,32,1649,596,168,645,607,0,353,254,38,3292,2527,22,1833,672,765,971,15.2,6.9,5.9,23.2,317938.2578125,3110.30728273144
48450,10460,10460,36005039300,181726,0,Census Tract 393,New York,Bronx County,2277,6382,3090,2445,32,1649,596,168,645,607,0,353,254,38,3292,2527,22,1833,672,765,971,15.2,6.9,5.9,23.2,317938.2578125,3110.30728273144
48451,10466,10466,36005039400,145220,0,Census Tract 394,New York,Bronx County,1864,3870,2365,2056,0,1578,286,192,309,272,0,272,0,37,1505,1190,0,994,196,315,544,14.1,9.3,12.0,20.9,254329.65234375,2244.6527030681
48451,10467,10467,36005039400,145220,0,Census Tract 394,New York,Bronx County,1864,3870,2365,2056,0,1578,286,192,309,272,0,272,0,37,1505,1190,0,994,196,315,544,14.1,9.3,12.0,20.9,254329.65234375,2244.6527030681
48452,10457,10457,36005039500,409402,0,Census Tract 395,New York,Bronx County,1360,2879,1776,1556,0,1180,180,196,220,175,0,153,22,45,1103,709,0,451,258,394,635,22.1,12.6,20.5,35.7,716177.56640625,4667.63228028649
48453,10466,10466,36005039600,223225,0,Census Tract 396,New York,Bronx County,1574,3402,1954,1747,0,1478,96,173,207,184,0,149,35,23,1448,1072,0,766,306,376,572,16.8,9.9,11.1,26.0,390918.91015625,2513.96235400596
48453,10467,10467,36005039600,223225,0,Census Tract 396,New York,Bronx County,1574,3402,1954,1747,0,1478,96,173,207,184,0,149,35,23,1448,1072,0,766,306,376,572,16.8,9.9,11.1,26.0,390918.91015625,2513.96235400596
48454,10458,10458,36005039700,518180,0,Census Tract 397,New York,Bronx County,468,994,581,507,0,453,15,39,74,74,0,74,0,0,413,263,0,257,6,150,189,19.0,7.7,0.0,36.3,906842.1015625,4497.8028218932395
48455,10466,10466,36005039800,201853,0,Census Tract 398,New York,Bronx County,1675,2951,2068,1824,0,1378,297,149,244,220,0,198,22,24,883,731,0,556,175,152,325,11.0,8.2,9.8,17.2,353476.83203125,2382.8892956596696
48455,10469,10469,36005039800,201853,0,Census Tract 398,New York,Bronx County,1675,2951,2068,1824,0,1378,297,149,244,220,0,198,22,24,883,731,0,556,175,152,325,11.0,8.2,9.8,17.2,353476.83203125,2382.8892956596696
48456,10458,10458,36005039901,151654,0,Census Tract 399.01,New York,Bronx County,1977,4326,2364,2051,0,1830,147,74,313,313,0,259,54,0,1962,1481,0,1278,203,481,555,12.8,3.6,0.0,24.5,265412.6875,2135.73073804458
48457,10458,10458,36005039902,121399,0,Census Tract 399.02,New York,Bronx County,1968,3992,2487,2054,8,1789,171,86,433,414,0,327,87,19,1505,1261,9,1007,245,244,349,8.7,4.2,4.4,16.2,212446.61328125,2071.77994586334
48458,10468,10468,36005040100,170429,0,Census Tract 401,New York,Bronx County,1681,3489,2274,1841,0,1432,249,160,433,342,0,311,31,91,1215,1061,0,800,261,154,405,11.6,8.7,21.0,12.7,298286.32421875,2277.09048776159
48459,10458,10458,36005040302,62696,0,Census Tract 403.02,New York,Bronx County,1775,3186,2156,1864,0,1481,294,89,292,282,0,262,20,10,1030,800,0,707,93,230,329,10.3,4.8,3.4,22.3,109741.64453125,1790.94085785882
48460,10468,10468,36005040303,87550,0,Census Tract 403.03,New York,Bronx County,2170,3963,2487,2251,0,1881,289,81,236,211,0,184,27,25,1476,1297,0,1206,91,179,285,7.2,3.6,10.6,12.1,153250.76171875,1559.93992905366
48461,10468,10468,36005040304,67355,0,Census Tract 403.04,New York,Bronx County,1440,2542,1787,1532,0,1267,173,92,255,255,0,255,0,0,755,587,0,503,84,168,260,10.2,6.0,0.0,22.3,117894.47265625,1396.4630081082598
48462,10466,10466,36005040400,215289,0,Census Tract 404,New York,Bronx County,1561,2770,1777,1609,0,1351,210,48,168,156,0,139,17,12,993,940,0,613,327,53,113,4.1,3.0,7.1,5.3,377040.3671875,2466.78795903559
48463,10458,10458,36005040501,82860,0,Census Tract 405.01,New York,Bronx County,1816,3326,2019,1831,0,1617,199,15,188,188,0,128,60,0,1307,1153,0,990,163,154,169,5.1,0.8,0.0,11.8,145034.65234375,1838.4889400503
48464,10458,10458,36005040502,141217,0,Census Tract 405.02,New York,Bronx County,3050,5519,3726,3148,0,2590,460,98,578,537,0,354,183,41,1793,1598,0,1390,208,195,334,6.1,3.1,7.1,10.9,247165.421875,2159.63676914459
48465,10466,10466,36005040600,223327,0,Census Tract 406,New York,Bronx County,1547,2941,1799,1676,37,1364,146,129,123,101,0,56,45,22,1142,831,73,566,192,311,462,15.7,7.7,17.9,27.2,391138.05859375,2517.6047358208602
48466,10468,10468,36005040701,58237,0,Census Tract 407.01,New York,Bronx County,1564,2503,1801,1682,0,1371,193,118,119,119,0,119,0,0,702,536,0,477,59,166,284,11.3,7.0,0.0,23.6,101945.66796875,1573.87678809508
48467,10458,10458,36005040702,182164,0,Census Tract 407.02,New York,Bronx County,2887,5462,3610,3242,0,2506,381,355,368,356,0,278,78,12,1852,1339,0,1069,270,513,880,16.1,11.0,3.3,27.7,318864.0078125,2500.0659096783397
48468,10466,10466,36005040800,124014,0,Census Tract 408,New York,Bronx County,1781,3394,2259,1825,0,1653,128,44,434,347,0,260,87,87,1135,1046,0,799,247,89,220,6.5,2.4,20.0,7.8,217213.26171875,2031.1840454686899
48469,10463,10463,36005040900,825703,345779,Census Tract 409,New York,Bronx County,1599,2653,1881,1644,0,1534,65,45,237,197,0,183,14,40,772,676,0,645,31,96,181,6.8,2.7,16.9,12.4,2051062.25,6264.212106495551
48469,10468,10468,36005040900,825703,345779,Census Tract 409,New York,Bronx County,1599,2653,1881,1644,0,1534,65,45,237,197,0,183,14,40,772,676,0,645,31,96,181,6.8,2.7,16.9,12.4,2051062.25,6264.212106495551
48470,10468,10468,36005041100,121611,0,Census Tract 411,New York,Bronx County,1811,3014,2118,1968,0,1498,313,157,150,146,0,110,36,4,896,754,0,516,238,142,303,10.1,8.0,2.7,15.8,212917.74609375,2364.44224569616
48471,10458,10458,36005041300,173358,0,Census Tract 413,New York,Bronx County,4081,5977,4440,4160,0,3627,454,79,280,280,0,280,0,0,1537,1389,0,1322,67,148,227,3.8,1.9,0.0,9.6,303494.67578125,2580.68398468297
48472,10470,10470,36005041400,522982,0,Census Tract 414,New York,Bronx County,2394,4318,2605,2419,36,2106,252,25,186,177,0,166,11,9,1713,1603,28,1340,235,110,144,3.3,1.0,4.8,6.4,916382.69140625,5808.3701492827695
48473,10458,10458,36005041500,135858,0,Census Tract 415,New York,Bronx County,2745,4795,3458,3078,0,2151,594,333,380,355,0,231,124,25,1337,1209,0,1168,41,128,486,10.1,10.8,6.6,9.6,237816.0546875,2090.86972757393
48474,10466,10466,36005041800,268871,0,Census Tract 418,New York,Bronx County,1706,3181,2156,1801,0,1234,472,95,355,327,0,221,106,28,1025,821,0,630,191,204,327,10.3,5.3,7.9,19.9,471029.2421875,2944.47792197294
48474,10470,10470,36005041800,268871,0,Census Tract 418,New York,Bronx County,1706,3181,2156,1801,0,1234,472,95,355,327,0,221,106,28,1025,821,0,630,191,204,327,10.3,5.3,7.9,19.9,471029.2421875,2944.47792197294
48475,10467,10467,36005041900,325906,0,Census Tract 419,New York,Bronx County,2949,5029,3537,3061,0,2635,314,112,476,255,0,192,63,221,1492,1300,0,1137,163,192,525,10.4,3.7,46.4,12.9,570610.22265625,3461.50531912655
48476,10466,10466,36005042000,150497,0,Census Tract 420,New York,Bronx County,1503,2998,1834,1611,0,1108,395,108,223,223,0,208,15,0,1164,834,0,544,290,330,438,14.6,6.7,0.0,28.4,263622.0,2039.62081034464
48477,10467,10467,36005042100,246182,0,Census Tract 421,New York,Bronx County,2316,4247,2786,2395,0,2219,97,79,391,391,0,314,77,0,1461,1192,0,1127,65,269,348,8.2,3.3,0.0,18.4,431084.19921875,3495.7427545985997
48478,10466,10466,36005042200,174693,0,Census Tract 422,New York,Bronx County,1447,2571,1653,1481,66,1253,128,34,172,172,0,161,11,0,918,848,73,656,119,70,104,4.0,2.3,0.0,7.6,305992.21875,2251.5940227983397
48479,10467,10467,36005042300,180376,0,Census Tract 423,New York,Bronx County,1921,3384,2330,2117,0,1833,88,196,213,176,0,101,75,37,1054,847,0,729,118,207,440,13.0,9.3,17.4,19.6,315810.07421875,2493.2481213415804
48480,10466,10466,36005042400,175087,0,Census Tract 424,New York,Bronx County,1172,1951,1327,1254,0,1041,131,82,73,73,0,58,15,0,624,462,0,447,15,162,244,12.5,6.5,0.0,26.0,306664.98046875,2292.9991635389
48481,10458,10458,36005042500,293818,0,Census Tract 425,New York,Bronx County,2915,4727,3573,3082,0,2504,411,167,491,438,0,324,114,53,1154,983,0,685,298,171,391,8.3,5.4,10.8,14.8,514338.1796875,3362.6430068656396
48481,10467,10467,36005042500,293818,0,Census Tract 425,New York,Bronx County,2915,4727,3573,3082,0,2504,411,167,491,438,0,324,114,53,1154,983,0,685,298,171,391,8.3,5.4,10.8,14.8,514338.1796875,3362.6430068656396
48482,10466,10466,36005042600,507577,0,Census Tract 426,New York,Bronx County,3285,5521,3657,3420,0,3086,199,135,237,185,0,185,0,52,1864,1690,0,1495,195,174,361,6.5,3.9,21.9,9.3,889057.0703125,4490.69795601026
48483,10466,10466,36005042800,169199,0,Census Tract 428,New York,Bronx County,1034,1768,1124,1097,5,970,59,63,27,17,0,17,0,10,644,533,12,455,66,111,184,10.4,5.7,37.0,17.2,296397.4609375,2187.87138467439
48484,10467,10467,36005042901,102256,0,Census Tract 429.01,New York,Bronx County,1499,2974,1742,1635,0,1339,160,136,107,89,0,79,10,18,1232,995,0,881,114,237,391,13.1,8.3,16.8,19.2,179023.359375,2612.5362176888198
48485,10467,10467,36005042902,94576,0,Census Tract 429.02,New York,Bronx County,1557,3216,2090,1712,0,1476,81,155,378,378,0,354,24,0,1126,826,11,749,66,300,455,14.1,9.1,0.0,26.6,165586.734375,1853.3471272810998
48486,10466,10466,36005043000,206163,0,Census Tract 430,New York,Bronx County,1570,2947,1919,1677,0,1388,182,107,242,242,0,212,30,0,1028,898,0,825,73,130,237,8.0,6.4,0.0,12.6,361138.3203125,2359.71562226964
48487,10467,10467,36005043100,214577,0,Census Tract 431,New York,Bronx County,3755,7901,4588,4157,0,3096,659,402,431,384,0,333,51,47,3313,2631,36,2157,438,682,1131,14.3,9.7,10.9,20.6,375747.84375,4269.51472988755
48488,10466,10466,36005043400,350972,0,Census Tract 434,New York,Bronx County,1567,2971,1958,1775,0,1247,320,208,183,138,0,138,0,45,1013,884,0,733,151,129,382,12.9,11.7,24.6,12.7,614887.2578125,4180.80882688461
48488,10470,10470,36005043400,350972,0,Census Tract 434,New York,Bronx County,1567,2971,1958,1775,0,1247,320,208,183,138,0,138,0,45,1013,884,0,733,151,129,382,12.9,11.7,24.6,12.7,614887.2578125,4180.80882688461
48489,10467,10467,36005043500,6714066,32176,Census Tract 435,New York,Bronx County,80,226,124,94,0,80,0,14,30,30,0,30,0,0,102,77,0,49,28,25,39,17.3,14.9,0.0,24.5,11817811.6054688,18507.750330106002
48489,10470,10470,36005043500,6714066,32176,Census Tract 435,New York,Bronx County,80,226,124,94,0,80,0,14,30,30,0,30,0,0,102,77,0,49,28,25,39,17.3,14.9,0.0,24.5,11817811.6054688,18507.750330106002
48489,10471,10471,36005043500,6714066,32176,Census Tract 435,New York,Bronx County,80,226,124,94,0,80,0,14,30,30,0,30,0,0,102,77,0,49,28,25,39,17.3,14.9,0.0,24.5,11817811.6054688,18507.750330106002
48490,10466,10466,36005043600,154651,0,Census Tract 436,New York,Bronx County,1014,1667,1109,1038,0,929,85,24,71,71,0,71,0,0,558,501,0,436,65,57,81,4.9,2.3,0.0,10.2,270932.48828125,2249.06828860862
48491,10466,10466,36005044200,242879,0,Census Tract 442,New York,Bronx County,1682,2962,1931,1791,0,1409,273,109,140,129,0,97,32,11,1031,942,0,783,159,89,209,7.1,6.1,7.9,8.6,425587.01171875,2922.00093577454
48491,10470,10470,36005044200,242879,0,Census Tract 442,New York,Bronx County,1682,2962,1931,1791,0,1409,273,109,140,129,0,97,32,11,1031,942,0,783,159,89,209,7.1,6.1,7.9,8.6,425587.01171875,2922.00093577454
48492,10466,10466,36005044400,365065,0,Census Tract 444,New York,Bronx County,2087,3428,2261,2109,0,1915,172,22,152,115,0,96,19,37,1167,1001,0,908,93,166,225,6.6,1.0,24.3,14.2,639601.42578125,3148.7609957847303
48493,10466,10466,36005044800,168089,0,Census Tract 448,New York,Bronx County,1005,1644,1112,1025,0,966,39,20,87,87,0,73,14,0,532,511,0,480,31,21,41,2.5,2.0,0.0,3.9,294461.50390625,2198.3511302781303
48494,10470,10470,36005044901,158135,0,Census Tract 449.01,New York,Bronx County,817,1438,906,828,0,761,56,11,78,72,0,72,0,6,532,340,7,292,41,192,209,14.5,1.3,7.7,36.1,277038.71875,2250.42497678672
48495,10470,10470,36005044902,156698,0,Census Tract 449.02,New York,Bronx County,927,1510,1038,977,7,850,70,50,61,61,0,53,8,0,472,375,0,298,77,97,147,9.7,5.1,0.0,20.6,274533.42578125,2444.26085882956
48496,10470,10470,36005045101,176003,0,Census Tract 451.01,New York,Bronx County,829,1342,863,836,9,813,7,7,27,27,9,18,0,0,479,359,8,340,11,120,127,9.5,0.8,0.0,25.1,308340.08984375,2670.02656788055
48497,10470,10470,36005045102,205999,0,Census Tract 451.02,New York,Bronx County,858,1515,932,893,0,813,45,35,39,39,0,33,6,0,583,441,13,383,45,142,177,11.7,3.9,0.0,24.4,360926.2890625,3464.52492285315
48498,10464,10464,36005045600,826610,16840,Census Tract 456,New York,Bronx County,1763,2868,1902,1788,14,1465,284,25,114,114,0,114,0,0,966,833,13,720,100,133,158,5.5,1.4,0.0,13.8,1461859.15234375,11443.8937951745
48498,10466,10466,36005045600,826610,16840,Census Tract 456,New York,Bronx County,1763,2868,1902,1788,14,1465,284,25,114,114,0,114,0,0,966,833,13,720,100,133,158,5.5,1.4,0.0,13.8,1461859.15234375,11443.8937951745
48498,10475,10475,36005045600,826610,16840,Census Tract 456,New York,Bronx County,1763,2868,1902,1788,14,1465,284,25,114,114,0,114,0,0,966,833,13,720,100,133,158,5.5,1.4,0.0,13.8,1461859.15234375,11443.8937951745
48499,10466,10466,36005045800,239682,0,Census Tract 458,New York,Bronx County,1511,3985,1820,1565,0,1365,146,54,255,255,0,255,0,0,2165,1551,0,1483,68,614,668,16.8,3.5,0.0,28.4,419757.23828125,2608.48014802104
48500,10466,10466,36005046000,287815,0,Census Tract 460,New York,Bronx County,914,2124,1074,954,0,658,256,40,120,120,0,79,41,0,1050,812,0,687,125,238,278,13.1,4.2,0.0,22.7,504000.640625,3032.88613216791
48500,10469,10469,36005046000,287815,0,Census Tract 460,New York,Bronx County,914,2124,1074,954,0,658,256,40,120,120,0,79,41,0,1050,812,0,687,125,238,278,13.1,4.2,0.0,22.7,504000.640625,3032.88613216791
48501,10475,10475,36005046201,2059737,134333,Census Tract 462.01,New York,Bronx County,13142,23251,14216,13444,0,12238,904,302,772,772,0,772,0,0,9035,7161,0,5766,1395,1874,2176,9.4,2.2,0.0,20.7,3657412.8515625,8893.73280570007
48502,10469,10469,36005046202,939524,14970,Census Tract 462.02,New York,Bronx County,3441,6902,4421,3603,34,2996,411,162,818,637,0,528,109,181,2481,2178,0,1719,459,303,646,9.4,4.5,22.1,12.2,1653374.93359375,9360.30877106702
48502,10475,10475,36005046202,939524,14970,Census Tract 462.02,New York,Bronx County,3441,6902,4421,3603,34,2996,411,162,818,637,0,528,109,181,2481,2178,0,1719,459,303,646,9.4,4.5,22.1,12.2,1653374.93359375,9360.30877106702
48503,10466,10466,36005048400,697175,0,Census Tract 484,New York,Bronx County,2225,3462,2493,2272,0,2151,74,47,221,221,0,221,0,0,969,814,0,805,9,155,202,5.8,2.1,0.0,16.0,1220986.34375,5034.12062551075
48504,10464,10464,36005050400,7243541,8954640,Census Tract 504,New York,Bronx County,75,116,94,94,0,62,13,19,0,0,0,0,0,0,22,22,0,13,9,0,19,16.4,20.2,,0.0,12653566.8554688,34897.7875080358
48505,10464,10464,36005051600,1538437,7811636,Census Tract 516,New York,Bronx County,2158,3390,2310,2158,0,2058,100,0,152,137,0,122,15,15,1080,839,0,803,36,241,256,7.6,0.0,9.9,22.3,2849691.640625,16455.7902795506
48506,11201,11201,36047000100,207819,0,Census Tract 1,New York,Kings County,2399,3659,2501,2467,0,2204,195,68,34,34,0,34,0,0,1158,1039,20,970,49,119,187,5.1,2.8,0.0,10.3,361939.609375,2631.5561704277698
48507,11220,11220,36047000200,276929,0,Census Tract 2,New York,Kings County,449,930,557,518,0,353,96,69,39,21,0,21,0,18,373,327,0,225,102,46,133,14.3,13.3,46.2,12.3,481630.18359375,3661.72098063656
48507,11232,11232,36047000200,276929,0,Census Tract 2,New York,Kings County,449,930,557,518,0,353,96,69,39,21,0,21,0,18,373,327,0,225,102,46,133,14.3,13.3,46.2,12.3,481630.18359375,3661.72098063656
48508,11201,11201,36047000301,200994,0,Census Tract 3.01,New York,Kings County,2224,3137,2261,2240,0,2174,50,16,21,21,0,21,0,0,876,805,12,793,0,71,87,2.8,0.7,0.0,8.1,350013.828125,2601.9873452361
48509,11201,11201,36047000501,83724,0,Census Tract 5.01,New York,Kings County,1993,2762,2108,2029,9,1933,51,36,79,79,0,79,0,0,654,492,0,460,32,162,198,7.2,1.8,0.0,24.8,145799.0703125,1943.1793271054898
48510,11201,11201,36047000502,96799,0,Census Tract 5.02,New York,Kings County,1610,2203,1679,1618,10,1555,45,8,61,61,0,61,0,0,524,436,0,425,11,88,96,4.4,0.5,0.0,16.8,168562.18359375,1960.2654000667499
48511,11201,11201,36047000700,176776,0,Census Tract 7,New York,Kings County,2313,3109,2412,2321,0,2261,52,8,91,91,0,91,0,0,697,643,0,643,0,54,62,2.0,0.3,0.0,7.7,303941.4140625,2533.17544348335
48512,11201,11201,36047000900,163469,0,Census Tract 9,New York,Kings County,2713,3341,2808,2713,0,2713,0,0,95,95,0,95,0,0,533,495,0,477,18,38,38,1.1,0.0,0.0,7.1,284626.578125,2373.26961433837
48513,11201,11201,36047001100,168507,0,Census Tract 11,New York,Kings County,1120,1237,1186,1120,0,1102,18,0,66,66,0,66,0,0,51,51,0,51,0,0,0,0.0,0.0,0.0,0.0,293415.58203125,2309.0777577883
48514,11201,11201,36047001300,293167,0,Census Tract 13,New York,Kings County,969,1406,989,969,17,931,21,0,20,20,0,20,0,0,417,360,0,354,6,57,57,4.1,0.0,0.0,13.7,510546.48046875,3076.71354322463
48515,11201,11201,36047001500,307621,0,Census Tract 15,New York,Kings County,4742,6689,5223,4761,0,4686,56,19,462,462,0,426,36,0,1466,1253,0,1104,149,213,232,3.5,0.4,0.0,14.5,535662.8125,3962.7144098689296
48516,11220,11220,36047001800,2020170,4743277,Census Tract 18,New York,Kings County,0,0,0,0,0,0,0,0,0,0,0,0,0,0,0,0,0,0,0,0,0,,,,,4149779.109375,21292.8838955924
48516,11232,11232,36047001800,2020170,4743277,Census Tract 18,New York,Kings County,0,0,0,0,0,0,0,0,0,0,0,0,0,0,0,0,0,0,0,0,0,,,,,4149779.109375,21292.8838955924
48517,11220,11220,36047002000,154138,0,Census Tract 20,New York,Kings County,554,1106,709,633,0,352,202,79,76,56,0,18,38,20,397,313,0,242,71,84,183,16.5,12.5,26.3,21.2,268034.23828125,2189.2429049671696
48518,11201,11201,36047002100,528955,39281,Census Tract 21,New York,Kings County,3232,3847,3348,3243,0,3194,38,11,105,105,0,105,0,0,499,499,0,485,14,0,11,0.3,0.3,0.0,0.0,859493.12890625,4839.3524941266705
48519,11220,11220,36047002200,340046,0,Census Tract 22,New York,Kings County,1947,3872,2260,2045,0,1615,332,98,215,215,0,174,41,0,1612,1184,0,874,310,428,526,13.6,4.8,0.0,26.6,591229.859375,4135.01559972642
48520,11201,11201,36047002300,182214,0,Census Tract 23,New York,Kings County,916,3341,1660,1137,0,837,79,221,523,371,0,141,230,152,1681,1016,0,912,104,665,1038,31.1,19.4,29.1,39.6,317337.12109375,2526.60808181742
48521,11201,11201,36047002901,109261,0,Census Tract 29.01,New York,Kings County,1500,3053,1810,1592,0,1380,120,92,218,130,0,72,58,88,1243,1192,0,1038,154,51,231,7.6,5.8,40.4,4.1,190258.6640625,1738.59818775745
48521,11205,11205,36047002901,109261,0,Census Tract 29.01,New York,Kings County,1500,3053,1810,1592,0,1380,120,92,218,130,0,72,58,88,1243,1192,0,1038,154,51,231,7.6,5.8,40.4,4.1,190258.6640625,1738.59818775745
48522,11220,11220,36047003000,110188,0,Census Tract 30,New York,Kings County,867,1294,894,872,9,823,35,5,22,22,0,22,0,0,400,359,5,299,55,41,46,3.6,0.6,0.0,10.3,191555.3828125,1970.55297588474
48523,11201,11201,36047003100,285943,0,Census Tract 31,New York,Kings County,1187,1824,1271,1226,0,1171,16,39,45,45,0,38,7,0,553,444,0,418,26,109,148,8.1,3.2,0.0,19.7,497875.76953125,3075.0238948900105
48524,11201,11201,36047003300,164585,0,Census Tract 33,New York,Kings County,2465,3209,2646,2569,0,2454,11,104,77,77,0,77,0,0,563,403,0,369,34,160,264,8.2,4.0,0.0,28.4,286543.01953125,2548.30884174763
48524,11217,11217,36047003300,164585,0,Census Tract 33,New York,Kings County,2465,3209,2646,2569,0,2454,11,104,77,77,0,77,0,0,563,403,0,369,34,160,264,8.2,4.0,0.0,28.4,286543.01953125,2548.30884174763
48525,11209,11209,36047003400,477399,2572532,Census Tract 34,New York,Kings County,1521,2540,1675,1633,8,1479,34,112,42,42,0,42,0,0,865,693,17,676,0,172,284,11.2,6.9,0.0,19.9,823924.50390625,4029.4567382627897
48525,11220,11220,36047003400,477399,2572532,Census Tract 34,New York,Kings County,1521,2540,1675,1633,8,1479,34,112,42,42,0,42,0,0,865,693,17,676,0,172,284,11.2,6.9,0.0,19.9,823924.50390625,4029.4567382627897
48526,11217,11217,36047003500,133028,0,Census Tract 35,New York,Kings County,1057,1637,1139,1072,0,925,132,15,67,67,0,67,0,0,498,407,0,306,101,91,106,6.5,1.4,0.0,18.3,231581.63671875,2023.78155108874
48527,11209,11209,36047003600,125291,0,Census Tract 36,New York,Kings County,2101,3195,2160,2119,0,2013,88,18,41,41,0,41,0,0,1035,906,0,854,52,129,147,4.6,0.8,0.0,12.5,217782.796875,2019.46394504344
48528,11201,11201,36047003700,166441,0,Census Tract 37,New York,Kings County,1185,1370,1195,1185,0,1185,0,0,10,10,0,10,0,0,175,169,0,169,0,6,6,0.4,0.0,0.0,3.4,289782.890625,2921.42126816396
48528,11217,11217,36047003700,166441,0,Census Tract 37,New York,Kings County,1185,1370,1195,1185,0,1185,0,0,10,10,0,10,0,0,175,169,0,169,0,6,6,0.4,0.0,0.0,3.4,289782.890625,2921.42126816396
48529,11209,11209,36047003800,127478,320787,Census Tract 38,New York,Kings County,538,1188,608,561,0,523,15,23,47,47,0,47,0,0,580,430,7,407,16,150,173,14.6,4.1,0.0,25.9,227031.05859375,2075.3159238998
48530,11217,11217,36047003900,156923,0,Census Tract 39,New York,Kings County,1450,1947,1586,1481,0,1391,59,31,105,94,0,82,12,11,361,279,0,237,42,82,124,6.4,2.1,10.5,22.7,273174.74609375,2054.97314544587
48531,11201,11201,36047004100,162018,0,Census Tract 41,New York,Kings County,2075,2638,2167,2075,0,2056,19,0,92,92,0,92,0,0,471,412,0,412,0,59,59,2.2,0.0,0.0,12.5,282059.796875,2124.75703023069
48531,11217,11217,36047004100,162018,0,Census Tract 41,New York,Kings County,2075,2638,2167,2075,0,2056,19,0,92,92,0,92,0,0,471,412,0,412,0,59,59,2.2,0.0,0.0,12.5,282059.796875,2124.75703023069
48532,11201,11201,36047004300,165381,0,Census Tract 43,New York,Kings County,2372,2848,2476,2419,8,2347,17,47,57,57,0,57,0,0,372,290,0,258,32,82,129,4.5,1.9,0.0,22.0,287928.60546875,2285.75264073332
48533,11209,11209,36047004400,419483,817305,Census Tract 44,New York,Kings County,1236,2075,1287,1257,9,1215,12,21,30,30,4,26,0,0,788,755,0,725,30,33,54,2.6,1.7,0.0,4.2,748614.6875,3622.70575447988
48534,11201,11201,36047004500,170539,0,Census Tract 45,New York,Kings County,2045,2881,2130,2045,0,1985,60,0,85,85,0,85,0,0,751,671,0,662,9,80,80,2.8,0.0,0.0,10.7,296904.84375,2213.9692155984
48535,11209,11209,36047004600,289094,528144,Census Tract 46,New York,Kings County,517,1029,543,517,0,471,46,0,26,20,0,20,0,6,486,468,0,395,73,18,24,2.3,0.0,23.1,3.7,521516.40234375,4418.57982037997
48536,11201,11201,36047004700,283960,0,Census Tract 47,New York,Kings County,1009,1371,1137,1028,0,985,24,19,109,83,0,83,0,26,234,234,0,201,33,0,45,3.3,1.8,23.9,0.0,494324.828125,4085.58620727859
48536,11231,11231,36047004700,283960,0,Census Tract 47,New York,Kings County,1009,1371,1137,1028,0,985,24,19,109,83,0,83,0,26,234,234,0,201,33,0,45,3.3,1.8,23.9,0.0,494324.828125,4085.58620727859
48537,11201,11201,36047004900,97532,0,Census Tract 49,New York,Kings County,1462,1871,1514,1462,0,1462,0,0,52,52,0,52,0,0,357,340,0,332,8,17,17,0.9,0.0,0.0,4.8,169801.63671875,2225.94775142585
48537,11231,11231,36047004900,97532,0,Census Tract 49,New York,Kings County,1462,1871,1514,1462,0,1462,0,0,52,52,0,52,0,0,357,340,0,332,8,17,17,0.9,0.0,0.0,4.8,169801.63671875,2225.94775142585
48538,11209,11209,36047005000,223992,535603,Census Tract 50,New York,Kings County,1190,1780,1304,1215,0,1184,6,25,89,89,0,89,0,0,476,442,0,396,46,34,59,3.3,2.1,0.0,7.1,422216.10546875,3283.70516077688
48539,11231,11231,36047005100,179702,0,Census Tract 51,New York,Kings County,1618,2082,1679,1625,0,1574,44,7,54,54,0,54,0,0,403,339,0,322,17,64,71,3.4,0.4,0.0,15.9,312818.7421875,2433.35189378989
48540,11209,11209,36047005201,133678,192294,Census Tract 52.01,New York,Kings County,637,1488,755,720,0,628,9,83,35,35,0,35,0,0,733,274,0,255,19,459,542,36.4,11.5,0.0,62.6,249630.31640625,2331.05534082441
48541,11209,11209,36047005202,133273,440002,Census Tract 52.02,New York,Kings County,1225,2036,1302,1264,12,1206,7,39,38,38,0,38,0,0,734,658,10,565,83,76,115,5.6,3.1,0.0,10.4,258394.21875,2225.23429872106
48542,11231,11231,36047005300,1651843,5374846,Census Tract 53,New York,Kings County,1280,1770,1381,1319,0,1206,74,39,62,62,0,62,0,0,389,347,0,300,47,42,81,4.6,3.0,0.0,10.8,2856497.62890625,16414.2831842526
48543,11209,11209,36047005400,161905,125113,Census Tract 54,New York,Kings County,1736,2830,1834,1762,0,1693,43,26,72,72,0,72,0,0,996,831,0,712,119,165,191,6.7,1.5,0.0,16.6,288608.30859375,3111.17935414406
48544,11209,11209,36047005601,173443,207530,Census Tract 56.01,New York,Kings County,1339,2216,1454,1350,0,1325,14,11,104,104,0,104,0,0,762,551,0,525,26,211,222,10.0,0.8,0.0,27.7,311527.24609375,2807.65064150818
48545,11209,11209,36047005602,135056,356364,Census Tract 56.02,New York,Kings County,904,1399,940,904,0,875,29,0,36,36,0,36,0,0,459,328,0,321,7,131,131,9.4,0.0,0.0,28.5,277626.74609375,2369.1667992188395
48546,11209,11209,36047005800,193316,0,Census Tract 58,New York,Kings County,1476,2585,1690,1511,0,1400,76,35,179,166,0,166,0,13,895,727,8,558,161,168,216,8.4,2.3,7.3,18.8,335870.69921875,2449.70106953077
48547,11231,11231,36047005900,355163,0,Census Tract 59,New York,Kings County,800,1080,839,829,0,794,6,29,10,10,0,10,0,0,241,115,0,115,0,126,155,14.4,3.5,0.0,52.3,618169.65234375,4084.7036992751296
48548,11209,11209,36047006000,152260,0,Census Tract 60,New York,Kings County,1619,2419,1733,1691,0,1565,54,72,42,42,0,42,0,0,686,561,0,516,45,125,197,8.1,4.3,0.0,18.2,264561.40234375,2208.70840941238
48549,11209,11209,36047006200,162273,0,Census Tract 62,New York,Kings County,1259,2061,1351,1302,0,1189,70,43,49,49,0,49,0,0,710,584,0,579,5,126,169,8.2,3.3,0.0,17.7,281985.578125,2156.4772750086604
48550,11231,11231,36047006300,103152,0,Census Tract 63,New York,Kings County,1158,1609,1216,1163,0,1153,5,5,53,53,0,53,0,0,393,343,0,329,14,50,55,3.4,0.4,0.0,12.7,179552.4609375,2339.53546623474
48551,11209,11209,36047006400,203176,0,Census Tract 64,New York,Kings County,1513,2680,1620,1531,57,1447,9,18,89,89,0,52,37,0,1060,868,0,748,120,192,210,7.8,1.2,0.0,18.1,353102.60546875,2381.39029878398
48552,11231,11231,36047006500,249988,0,Census Tract 65,New York,Kings County,3639,4643,3828,3685,0,3609,30,46,143,127,0,127,0,16,815,576,0,530,46,239,301,6.5,1.2,11.2,29.3,435106.578125,3188.72425257696
48553,11209,11209,36047006600,153740,0,Census Tract 66,New York,Kings County,1838,2969,2033,1875,0,1779,59,37,158,158,0,138,20,0,936,765,0,696,69,171,208,7.0,2.0,0.0,18.3,267214.9609375,2106.50528366088
48554,11231,11231,36047006700,156140,0,Census Tract 67,New York,Kings County,2371,3173,2481,2377,0,2331,40,6,104,104,0,104,0,0,692,667,0,629,38,25,31,1.0,0.3,0.0,3.6,271806.2578125,2106.0820399683
48555,11209,11209,36047006800,185509,0,Census Tract 68,New York,Kings County,2236,3878,2544,2312,0,2123,113,76,232,223,0,210,13,9,1334,1172,17,1024,131,162,247,6.4,3.3,3.9,12.1,322458.109375,2347.25939928207
48555,11220,11220,36047006800,185509,0,Census Tract 68,New York,Kings County,2236,3878,2544,2312,0,2123,113,76,232,223,0,210,13,9,1334,1172,17,1024,131,162,247,6.4,3.3,3.9,12.1,322458.109375,2347.25939928207
48556,11201,11201,36047006900,179076,0,Census Tract 69,New York,Kings County,2373,3080,2500,2402,9,2309,55,29,98,98,0,98,0,0,580,522,10,488,24,58,87,2.8,1.2,0.0,10.0,311741.92578125,2237.77056781297
48556,11231,11231,36047006900,179076,0,Census Tract 69,New York,Kings County,2373,3080,2500,2402,9,2309,55,29,98,98,0,98,0,0,580,522,10,488,24,58,87,2.8,1.2,0.0,10.0,311741.92578125,2237.77056781297
48557,11220,11220,36047007000,149197,0,Census Tract 70,New York,Kings County,1188,2128,1237,1196,0,1135,53,8,41,41,0,41,0,0,891,726,0,600,126,165,173,8.1,0.7,0.0,18.5,259362.48828125,2879.474554335
48558,11217,11217,36047007100,167532,3828,Census Tract 71,New York,Kings County,1825,4010,2226,1883,0,1609,216,58,343,286,0,252,34,57,1784,1481,0,1271,210,303,418,10.4,3.1,16.6,17.0,291629.2890625,2440.01284852893
48559,11220,11220,36047007200,62490,0,Census Tract 72,New York,Kings County,881,1451,937,898,0,699,182,17,39,39,0,26,13,0,514,388,0,383,5,126,143,9.9,1.9,0.0,24.5,108637.0390625,1418.49694616315
48560,11220,11220,36047007400,141287,0,Census Tract 74,New York,Kings County,1968,3906,2214,2035,0,1651,317,67,179,179,0,84,95,0,1692,1447,0,1312,135,245,312,8.0,3.3,0.0,14.5,245641.16015625,2005.8845922149899
48561,11217,11217,36047007500,282781,0,Census Tract 75,New York,Kings County,3161,4044,3303,3161,0,3128,33,0,142,142,0,134,8,0,741,738,13,590,135,3,3,0.1,0.0,0.0,0.4,492219.17578125,3003.28818389253
48561,11231,11231,36047007500,282781,0,Census Tract 75,New York,Kings County,3161,4044,3303,3161,0,3128,33,0,142,142,0,134,8,0,741,738,13,590,135,3,3,0.1,0.0,0.0,0.4,492219.17578125,3003.28818389253
48562,11220,11220,36047007600,138336,0,Census Tract 76,New York,Kings County,2228,4072,2576,2368,0,1761,467,140,208,208,0,172,36,0,1496,1147,0,821,326,349,489,12.0,5.9,0.0,23.3,240526.54296875,1988.94517465887
48563,11231,11231,36047007700,389476,0,Census Tract 77,New York,Kings County,2901,4006,3227,3011,0,2884,17,110,216,138,0,138,0,78,779,507,0,507,0,272,460,11.5,3.7,36.1,34.9,677848.0546875,4086.96447416269
48564,11220,11220,36047007800,138114,0,Census Tract 78,New York,Kings County,2419,4175,2865,2715,0,1926,493,296,150,150,0,125,25,0,1310,1011,0,788,223,299,595,14.3,10.9,0.0,22.8,240156.59765625,1985.9081426784699
48565,11220,11220,36047008000,139122,0,Census Tract 80,New York,Kings County,1615,3048,2059,1963,0,1394,221,348,96,60,0,60,0,36,989,551,0,450,101,438,822,27.0,17.7,37.5,44.3,241925.1640625,1991.41729122318
48566,11220,11220,36047008200,139684,0,Census Tract 82,New York,Kings County,1760,3074,2040,1812,0,1570,190,52,228,228,0,208,20,0,1034,809,0,587,222,225,277,9.0,2.9,0.0,21.8,242919.5390625,2006.84316241923
48566,11232,11232,36047008200,139684,0,Census Tract 82,New York,Kings County,1760,3074,2040,1812,0,1570,190,52,228,228,0,208,20,0,1034,809,0,587,222,225,277,9.0,2.9,0.0,21.8,242919.5390625,2006.84316241923
48567,11232,11232,36047008400,243910,0,Census Tract 84,New York,Kings County,1809,3036,2078,1950,0,1539,270,141,128,128,0,128,0,0,958,727,0,641,86,231,372,12.3,7.2,0.0,24.1,424210.5859375,2618.04040630279
48568,11231,11231,36047008500,243576,0,Census Tract 85,New York,Kings County,1457,5702,2454,1623,0,1392,65,166,831,632,0,573,59,199,3248,1961,0,1686,275,1287,1652,29.0,10.2,23.9,39.6,423906.87890625,3198.57816793948
48570,11232,11232,36047008800,189369,0,Census Tract 88,New York,Kings County,1437,2300,1503,1445,0,1350,87,8,58,30,0,18,12,28,797,644,0,592,52,153,189,8.2,0.6,48.3,19.2,329315.30859375,2295.8864668617302
48571,11232,11232,36047009000,148493,0,Census Tract 90,New York,Kings County,1412,2187,1532,1442,0,1241,171,30,90,90,0,90,0,0,655,625,0,489,136,30,60,2.7,2.1,0.0,4.6,258211.14453125,2086.66063501825
48572,11220,11220,36047009200,113217,0,Census Tract 92,New York,Kings County,2348,4257,2743,2479,0,2246,102,131,264,264,0,264,0,0,1514,1292,0,1258,34,222,353,8.3,5.3,0.0,14.7,196858.671875,1880.69047755298
48572,11232,11232,36047009200,113217,0,Census Tract 92,New York,Kings County,2348,4257,2743,2479,0,2246,102,131,264,264,0,264,0,0,1514,1292,0,1258,34,222,353,8.3,5.3,0.0,14.7,196858.671875,1880.69047755298
48573,11220,11220,36047009400,151026,0,Census Tract 94,New York,Kings County,2331,3943,2584,2478,0,1890,441,147,106,106,0,106,0,0,1359,1180,0,1026,154,179,326,8.3,5.9,0.0,13.2,262587.24609375,2091.66441319222
48574,11220,11220,36047009600,150752,0,Census Tract 96,New York,Kings County,2773,4798,3229,3049,0,2357,416,276,180,180,0,170,10,0,1569,1258,0,772,486,311,587,12.2,9.1,0.0,19.8,262125.10546875,2090.8814367363198
48575,11220,11220,36047009800,151006,0,Census Tract 98,New York,Kings County,2656,5083,3284,3143,0,2354,302,487,141,130,0,106,24,11,1799,1455,0,1256,199,344,842,16.6,15.5,7.8,19.1,262551.640625,2091.43637903766
48576,11220,11220,36047010000,150970,0,Census Tract 100,New York,Kings County,2741,4669,3182,2975,0,2341,400,234,207,193,0,193,0,14,1487,1282,0,1180,102,205,453,9.7,7.9,6.8,13.8,262473.26953125,2090.87858821444
48577,11232,11232,36047010100,314730,0,Census Tract 101,New York,Kings County,2268,3237,2382,2307,0,2067,201,39,75,69,0,69,0,6,855,623,0,590,33,232,277,8.6,1.7,8.0,27.1,547453.45703125,3047.81981685959
48578,11220,11220,36047010200,152450,0,Census Tract 102,New York,Kings County,2385,3807,2489,2426,0,1993,392,41,63,63,11,52,0,0,1318,1047,45,897,105,271,312,8.2,1.7,0.0,20.6,265031.2109375,2098.9144671555605
48579,11220,11220,36047010400,152312,0,Census Tract 104,New York,Kings County,2550,4248,2879,2726,0,2254,296,176,153,153,0,93,60,0,1369,1170,0,957,213,199,375,8.8,6.5,0.0,14.5,264768.4375,2098.49373642714
48580,11220,11220,36047010600,150932,0,Census Tract 106,New York,Kings County,1832,3691,2155,2028,0,1351,481,196,127,105,0,69,36,22,1536,1132,0,905,227,404,622,16.9,9.7,17.3,26.3,262387.3515625,2091.01170340923
48581,11220,11220,36047010800,150979,0,Census Tract 108,New York,Kings County,1623,3026,1859,1823,0,1303,320,200,36,28,0,28,0,8,1167,904,0,731,173,263,471,15.6,11.0,22.2,22.5,262482.984375,2091.13426965286
48582,11219,11219,36047011000,158059,0,Census Tract 110,New York,Kings County,840,1655,964,905,0,803,37,65,59,59,0,59,0,0,691,606,0,547,59,85,150,9.1,7.2,0.0,12.3,274820.4140625,2163.67384030174
48583,11219,11219,36047011200,171313,0,Census Tract 112,New York,Kings County,2045,4380,2441,2290,21,1490,534,245,151,143,0,135,8,8,1939,1317,57,1019,241,622,875,20.0,10.7,5.3,32.1,297847.4609375,2193.6980113795803
48584,11219,11219,36047011400,167792,0,Census Tract 114,New York,Kings County,1462,2415,1601,1554,0,1007,455,92,47,47,0,47,0,0,814,481,0,356,125,333,425,17.6,5.9,0.0,40.9,291702.796875,2194.97274788129
48585,11219,11219,36047011600,160266,0,Census Tract 116,New York,Kings County,1572,2619,1752,1629,0,1455,117,57,123,123,0,123,0,0,867,652,0,619,33,215,272,10.4,3.5,0.0,24.8,278588.4140625,2358.37084263536
48585,11220,11220,36047011600,160266,0,Census Tract 116,New York,Kings County,1572,2619,1752,1629,0,1455,117,57,123,123,0,123,0,0,867,652,0,619,33,215,272,10.4,3.5,0.0,24.8,278588.4140625,2358.37084263536
48586,11215,11215,36047011700,201195,0,Census Tract 117,New York,Kings County,1583,2269,1670,1611,29,1509,45,28,59,59,0,59,0,0,599,549,0,458,91,50,78,3.4,1.7,0.0,8.3,350073.74609375,2348.47877571055
48587,11219,11219,36047011800,219234,0,Census Tract 118,New York,Kings County,950,1588,1040,955,0,885,65,5,85,85,0,85,0,0,548,460,0,431,29,88,93,5.9,0.5,0.0,16.1,381077.03125,3197.5331124199797
48587,11220,11220,36047011800,219234,0,Census Tract 118,New York,Kings County,950,1588,1040,955,0,885,65,5,85,85,0,85,0,0,548,460,0,431,29,88,93,5.9,0.5,0.0,16.1,381077.03125,3197.5331124199797
48588,11215,11215,36047011900,654296,63596,Census Tract 119,New York,Kings County,859,1227,933,859,0,831,28,0,74,74,0,74,0,0,294,253,4,209,40,41,41,3.3,0.0,0.0,13.9,1147850.24609375,7802.20919019266
48588,11217,11217,36047011900,654296,63596,Census Tract 119,New York,Kings County,859,1227,933,859,0,831,28,0,74,74,0,74,0,0,294,253,4,209,40,41,41,3.3,0.0,0.0,13.9,1147850.24609375,7802.20919019266
48589,11219,11219,36047012000,193342,0,Census Tract 120,New York,Kings County,547,890,594,547,0,523,24,0,47,43,0,43,0,4,296,266,0,244,22,30,34,3.8,0.0,8.5,10.1,336052.8203125,3054.9592536809196
48589,11220,11220,36047012000,193342,0,Census Tract 120,New York,Kings County,547,890,594,547,0,523,24,0,47,43,0,43,0,4,296,266,0,244,22,30,34,3.8,0.0,8.5,10.1,336052.8203125,3054.9592536809196
48590,11215,11215,36047012100,148056,0,Census Tract 121,New York,Kings County,1308,1761,1337,1308,27,1248,33,0,29,29,0,29,0,0,424,389,47,327,15,35,35,2.0,0.0,0.0,8.3,257634.62109375,2067.8419602508498
48591,11220,11220,36047012200,181661,0,Census Tract 122,New York,Kings County,2259,4442,3017,2592,9,1985,265,333,425,425,0,379,46,0,1425,1168,9,968,191,257,590,13.3,12.8,0.0,18.0,315798.90625,2261.38517417578
48592,11220,11220,36047012600,235982,0,Census Tract 126,New York,Kings County,1412,2297,1503,1412,0,1371,41,0,91,91,0,91,0,0,794,732,0,678,54,62,62,2.7,0.0,0.0,7.8,410190.703125,3004.8520100853802
48593,11217,11217,36047012700,163391,0,Census Tract 127,New York,Kings County,1788,3904,2217,2010,0,1677,111,222,207,173,0,173,0,34,1687,635,0,509,126,1052,1308,33.5,11.0,16.4,62.4,284405.62109375,2135.48764031996
48594,11219,11219,36047012801,114974,0,Census Tract 128.01,New York,Kings County,923,1864,998,953,0,892,31,30,45,45,0,45,0,0,866,628,0,609,19,238,268,14.4,3.1,0.0,27.5,199828.234375,1938.7059412521899
48594,11220,11220,36047012801,114974,0,Census Tract 128.01,New York,Kings County,923,1864,998,953,0,892,31,30,45,45,0,45,0,0,866,628,0,609,19,238,268,14.4,3.1,0.0,27.5,199828.234375,1938.7059412521899
48595,11217,11217,36047012901,133304,0,Census Tract 129.01,New York,Kings County,1671,2256,1749,1671,0,1662,9,0,78,78,0,78,0,0,507,485,0,485,0,22,22,1.0,0.0,0.0,4.3,232037.69921875,2155.3890398476
48596,11217,11217,36047012902,130645,0,Census Tract 129.02,New York,Kings County,1273,1906,1399,1324,0,1251,22,51,75,75,0,75,0,0,507,392,0,349,43,115,166,8.7,3.9,0.0,22.7,227399.73046875,2142.25578062214
48597,11209,11209,36047013000,176429,0,Census Tract 130,New York,Kings County,2112,3793,2357,2177,0,2060,52,65,180,180,0,150,30,0,1436,1340,0,1260,80,96,161,4.2,3.0,0.0,6.7,306655.09765625,2269.89920710823
48597,11220,11220,36047013000,176429,0,Census Tract 130,New York,Kings County,2112,3793,2357,2177,0,2060,52,65,180,180,0,150,30,0,1436,1340,0,1260,80,96,161,4.2,3.0,0.0,6.7,306655.09765625,2269.89920710823
48598,11217,11217,36047013100,156385,0,Census Tract 131,New York,Kings County,2578,3424,2693,2589,0,2530,48,11,104,104,0,104,0,0,731,591,0,514,77,140,151,4.4,0.4,0.0,19.2,272181.3125,2124.53322339969
48599,11220,11220,36047013200,155778,0,Census Tract 132,New York,Kings County,904,1638,973,926,0,839,65,22,47,47,5,42,0,0,665,553,5,464,84,112,134,8.2,2.4,0.0,16.8,270722.5,2579.347815039
48599,11228,11228,36047013200,155778,0,Census Tract 132,New York,Kings County,904,1638,973,926,0,839,65,22,47,47,5,42,0,0,665,553,5,464,84,112,134,8.2,2.4,0.0,16.8,270722.5,2579.347815039
48600,11215,11215,36047013300,148501,0,Census Tract 133,New York,Kings County,2686,3448,2837,2696,0,2596,90,10,141,141,0,141,0,0,611,561,0,523,38,50,60,1.7,0.4,0.0,8.2,258437.1484375,2083.0071150560198
48601,11209,11209,36047013400,268236,0,Census Tract 134,New York,Kings County,1916,3368,2243,2038,0,1884,32,122,205,205,0,205,0,0,1125,1007,0,905,102,118,240,7.1,6.0,0.0,10.5,466179.6875,3502.58461030516
48602,11215,11215,36047013500,151867,0,Census Tract 135,New York,Kings County,2115,2849,2247,2163,0,2035,80,48,84,73,0,48,25,11,602,593,0,515,78,9,68,2.4,2.2,13.1,1.5,264276.87890625,2100.0834123989102
48603,11209,11209,36047013600,214252,0,Census Tract 136,New York,Kings County,1946,3058,2100,1946,0,1909,37,0,154,154,0,146,8,0,958,840,0,815,25,118,118,3.9,0.0,0.0,12.3,372332.89453125,3293.4853979981604
48604,11215,11215,36047013700,152453,0,Census Tract 137,New York,Kings County,1895,2721,2010,1895,0,1811,84,0,115,93,0,93,0,22,711,534,0,423,111,177,199,7.3,0.0,19.1,24.9,265278.890625,2103.92482091062
48605,11209,11209,36047013800,162579,0,Census Tract 138,New York,Kings County,1514,2592,1601,1525,25,1463,26,11,76,76,0,76,0,0,991,805,46,740,19,186,197,7.6,0.7,0.0,18.8,282512.48828125,2661.81865430472
48606,11215,11215,36047013900,151331,0,Census Tract 139,New York,Kings County,2141,2888,2251,2170,0,2123,18,29,81,81,0,81,0,0,637,567,0,554,13,70,99,3.4,1.3,0.0,11.0,263308.375,2096.61970116486
48607,11228,11228,36047014000,147522,0,Census Tract 140,New York,Kings County,1008,1631,1064,1028,6,969,33,20,36,30,0,30,0,6,567,434,7,420,7,133,159,9.7,1.9,16.7,23.5,256323.9375,2275.0407519238397
48608,11215,11215,36047014100,165483,0,Census Tract 141,New York,Kings County,1726,2465,1852,1726,0,1641,85,0,126,118,0,118,0,8,613,573,0,533,40,40,48,1.9,0.0,6.3,6.5,287910.08984375,2180.1947826701603
48609,11209,11209,36047014200,200223,0,Census Tract 142,New York,Kings County,1383,2340,1524,1394,0,1345,38,11,130,121,0,121,0,9,816,688,0,665,23,128,148,6.3,0.8,6.9,15.7,347911.53515625,3072.231769093
48610,11215,11215,36047014300,217211,0,Census Tract 143,New York,Kings County,2161,2996,2299,2185,0,2038,123,24,114,114,0,83,31,0,697,584,0,478,106,113,137,4.6,1.1,0.0,16.2,377887.00390625,2676.57072420345
48610,11232,11232,36047014300,217211,0,Census Tract 143,New York,Kings County,2161,2996,2299,2185,0,2038,123,24,114,114,0,83,31,0,697,584,0,478,106,113,137,4.6,1.1,0.0,16.2,377887.00390625,2676.57072420345
48611,11215,11215,36047014500,216621,0,Census Tract 145,New York,Kings County,2639,3344,2757,2653,0,2597,42,14,104,104,0,104,0,0,587,493,0,481,12,94,108,3.2,0.5,0.0,16.0,376833.9140625,2638.38301109486
48611,11232,11232,36047014500,216621,0,Census Tract 145,New York,Kings County,2639,3344,2757,2653,0,2597,42,14,104,104,0,104,0,0,587,493,0,481,12,94,108,3.2,0.5,0.0,16.0,376833.9140625,2638.38301109486
48612,11215,11215,36047014700,105979,0,Census Tract 147,New York,Kings County,1368,1949,1445,1373,0,1360,8,5,72,66,0,62,4,6,504,400,4,374,22,104,115,5.9,0.4,8.3,20.6,184353.52734375,1828.3550521785899
48613,11228,11228,36047014800,133459,0,Census Tract 148,New York,Kings County,508,1084,570,535,0,477,31,27,35,35,0,35,0,0,514,422,0,298,124,92,119,11.0,5.0,0.0,17.9,231855.9921875,2105.81750085344
48614,11215,11215,36047014900,249831,0,Census Tract 149,New York,Kings County,3372,4603,3654,3470,0,3246,126,98,184,155,0,155,0,29,949,850,0,782,68,99,226,4.9,2.8,15.8,10.4,434620.625,2618.08128233788
48615,11228,11228,36047015000,133505,0,Census Tract 150,New York,Kings County,705,1318,722,709,0,705,0,4,13,13,0,13,0,0,596,442,0,411,31,154,158,12.0,0.6,0.0,25.8,231929.73828125,2107.20395477096
48616,11215,11215,36047015100,149311,0,Census Tract 151,New York,Kings County,2349,3259,2420,2349,43,2269,37,0,71,71,0,71,0,0,839,697,33,633,31,142,142,4.4,0.0,0.0,16.9,259776.78125,2080.3317470707
48617,11209,11209,36047015200,268130,0,Census Tract 152,New York,Kings County,1093,1831,1150,1101,0,1048,45,8,49,49,0,49,0,0,681,593,7,526,60,88,96,5.2,0.7,0.0,12.9,465793.0625,3438.42075666846
48617,11228,11228,36047015200,268130,0,Census Tract 152,New York,Kings County,1093,1831,1150,1101,0,1048,45,8,49,49,0,49,0,0,681,593,7,526,60,88,96,5.2,0.7,0.0,12.9,465793.0625,3438.42075666846
48618,11215,11215,36047015300,150477,0,Census Tract 153,New York,Kings County,1418,2147,1541,1438,0,1377,41,20,103,103,0,103,0,0,606,588,0,533,55,18,38,1.8,1.4,0.0,3.0,261821.9140625,2085.69898071304
48619,11209,11209,36047015400,922940,0,Census Tract 154,New York,Kings County,0,0,0,0,0,0,0,0,0,0,0,0,0,0,0,0,0,0,0,0,0,,,,,1603152.953125,5870.693691143771
48619,11228,11228,36047015400,922940,0,Census Tract 154,New York,Kings County,0,0,0,0,0,0,0,0,0,0,0,0,0,0,0,0,0,0,0,0,0,,,,,1603152.953125,5870.693691143771
48620,11215,11215,36047015500,149645,0,Census Tract 155,New York,Kings County,2130,3167,2222,2130,0,2076,54,0,92,92,0,92,0,0,945,892,0,880,12,53,53,1.7,0.0,0.0,5.6,260393.52734375,2082.79328207216
48621,11215,11215,36047015700,167428,0,Census Tract 157,New York,Kings County,2514,3449,2614,2529,0,2471,43,15,85,85,0,85,0,0,835,835,0,781,54,0,15,0.4,0.6,0.0,0.0,291358.32421875,2182.1971223325304
48622,11217,11217,36047015900,250867,0,Census Tract 159,New York,Kings County,3238,4457,3395,3252,0,3173,65,14,143,143,0,143,0,0,1062,978,26,934,18,84,98,2.2,0.4,0.0,7.9,436591.5390625,2839.5926421448103
48622,11238,11238,36047015900,250867,0,Census Tract 159,New York,Kings County,3238,4457,3395,3252,0,3173,65,14,143,143,0,143,0,0,1062,978,26,934,18,84,98,2.2,0.4,0.0,7.9,436591.5390625,2839.5926421448103
48623,11209,11209,36047016000,258630,0,Census Tract 160,New York,Kings County,2060,3313,2167,2112,0,1999,61,52,55,55,0,55,0,0,1146,1034,0,963,71,112,164,5.0,2.5,0.0,9.8,449347.39453125,3180.29520731548
48624,11217,11217,36047016100,182397,0,Census Tract 161,New York,Kings County,1825,2716,1906,1825,0,1785,40,0,81,81,0,81,0,0,810,798,0,771,27,12,12,0.4,0.0,0.0,1.5,317474.484375,2604.97022638236
48625,11209,11209,36047016200,237712,0,Census Tract 162,New York,Kings County,1085,1914,1313,1156,18,1040,27,71,157,157,8,127,22,0,601,447,34,378,35,154,225,11.8,6.1,0.0,25.6,412931.703125,3392.98706512067
48626,11238,11238,36047016300,184092,0,Census Tract 163,New York,Kings County,1966,2649,2059,2000,0,1895,71,34,59,46,0,46,0,13,590,481,0,472,9,109,156,5.9,1.7,22.0,18.5,320417.32421875,2453.15593468556
48627,11209,11209,36047016400,802167,650272,Census Tract 164,New York,Kings County,324,458,324,324,0,313,11,0,0,0,0,0,0,0,134,134,0,134,0,0,0,0.0,0.0,,0.0,1393932.69140625,6572.73006277313
48627,11425,11209,36047016400,802167,650272,Census Tract 164,New York,Kings County,324,458,324,324,0,313,11,0,0,0,0,0,0,0,134,134,0,134,0,0,0,0.0,0.0,,0.0,1393932.69140625,6572.73006277313
48628,11215,11215,36047016500,186642,0,Census Tract 165,New York,Kings County,3655,4627,3753,3655,0,3629,26,0,98,98,0,98,0,0,874,838,0,822,16,36,36,0.8,0.0,0.0,4.1,324766.359375,2708.0723213026604
48629,11228,11228,36047016600,266930,0,Census Tract 166,New York,Kings County,869,1551,923,891,0,854,15,22,32,32,0,32,0,0,628,443,0,419,24,185,207,13.3,2.5,0.0,29.5,463764.58984375,2735.09331229066
48630,11215,11215,36047016700,168915,0,Census Tract 167,New York,Kings County,3300,4252,3426,3348,0,3116,184,48,78,78,0,78,0,0,826,752,0,724,28,74,122,2.9,1.4,0.0,9.0,293869.9921875,2490.87455625172
48631,11214,11214,36047016800,168295,117619,Census Tract 168,New York,Kings County,788,1426,816,813,0,776,12,25,3,3,0,3,0,0,610,511,0,473,38,99,124,8.7,3.1,0.0,16.2,297548.63671875,2268.07037179613
48631,11228,11228,36047016800,168295,117619,Census Tract 168,New York,Kings County,788,1426,816,813,0,776,12,25,3,3,0,3,0,0,610,511,0,473,38,99,124,8.7,3.1,0.0,16.2,297548.63671875,2268.07037179613
48632,11215,11215,36047016900,209462,0,Census Tract 169,New York,Kings County,2953,4027,3023,2953,0,2953,0,0,70,70,0,70,0,0,1004,702,0,669,33,302,302,7.5,0.0,0.0,30.1,364361.30859375,2470.9360416523
48633,11228,11228,36047017000,209047,0,Census Tract 170,New York,Kings County,1463,2805,1609,1523,0,1404,59,60,86,86,0,82,4,0,1196,1014,0,935,79,182,242,8.6,3.9,0.0,15.2,363101.07421875,2944.2176283680296
48634,11215,11215,36047017100,208489,0,Census Tract 171,New York,Kings County,2260,3237,2378,2271,0,2247,13,11,107,107,0,107,0,0,859,746,0,733,13,113,124,3.8,0.5,0.0,13.2,362638.828125,2468.30500424812
48634,11218,11218,36047017100,208489,0,Census Tract 171,New York,Kings County,2260,3237,2378,2271,0,2247,13,11,107,107,0,107,0,0,859,746,0,733,13,113,124,3.8,0.5,0.0,13.2,362638.828125,2468.30500424812
48635,11214,11214,36047017200,206304,0,Census Tract 172,New York,Kings County,1496,2790,1655,1544,0,1468,28,48,111,111,0,111,0,0,1135,982,0,975,7,153,201,7.2,3.1,0.0,13.5,358327.50390625,2916.86826922711
48635,11228,11228,36047017200,206304,0,Census Tract 172,New York,Kings County,1496,2790,1655,1544,0,1468,28,48,111,111,0,111,0,0,1135,982,0,975,7,153,201,7.2,3.1,0.0,13.5,358327.50390625,2916.86826922711
48636,11214,11214,36047017400,165550,91465,Census Tract 174,New York,Kings County,970,1702,1086,1005,0,889,81,35,81,81,0,81,0,0,616,486,0,436,50,130,165,9.7,3.5,0.0,21.1,296182.578125,2409.87597935655
48637,11215,11215,36047017500,1961397,0,Census Tract 175,New York,Kings County,0,0,0,0,0,0,0,0,0,0,0,0,0,0,0,0,0,0,0,0,0,,,,,3411112.53125,7541.109457257309
48638,11214,11214,36047017600,133636,83378,Census Tract 176,New York,Kings County,1185,2005,1311,1199,0,1175,10,14,112,102,0,102,0,10,694,564,0,560,4,130,154,7.7,1.2,8.9,18.7,247437.515625,2298.94889271075
48639,11218,11218,36047017700,2313042,227326,Census Tract 177,New York,Kings County,0,0,0,0,0,0,0,0,0,0,0,0,0,0,0,0,0,0,0,0,0,,,,,4419252.32421875,9723.1349777619
48639,11225,11225,36047017700,2313042,227326,Census Tract 177,New York,Kings County,0,0,0,0,0,0,0,0,0,0,0,0,0,0,0,0,0,0,0,0,0,,,,,4419252.32421875,9723.1349777619
48639,11238,11238,36047017700,2313042,227326,Census Tract 177,New York,Kings County,0,0,0,0,0,0,0,0,0,0,0,0,0,0,0,0,0,0,0,0,0,,,,,4419252.32421875,9723.1349777619
48640,11214,11214,36047017800,164020,0,Census Tract 178,New York,Kings County,1277,2246,1445,1366,30,1141,106,89,79,79,5,69,5,0,801,725,34,665,26,76,165,7.3,6.5,0.0,9.5,284866.32421875,2448.7754947978
48641,11217,11217,36047017900,158289,0,Census Tract 179,New York,Kings County,1739,3245,2006,1773,0,1562,177,34,233,233,0,222,11,0,1239,875,0,777,98,364,398,12.3,1.9,0.0,29.4,275547.171875,2143.44275918266
48641,11238,11238,36047017900,158289,0,Census Tract 179,New York,Kings County,1739,3245,2006,1773,0,1562,177,34,233,233,0,222,11,0,1239,875,0,777,98,364,398,12.3,1.9,0.0,29.4,275547.171875,2143.44275918266
48642,11214,11214,36047018000,176116,0,Census Tract 180,New York,Kings County,1613,2676,1744,1613,0,1584,29,0,131,131,0,113,18,0,932,872,0,830,42,60,60,2.2,0.0,0.0,6.4,305888.546875,2451.21081572578
48643,11205,11205,36047018100,169373,0,Census Tract 181,New York,Kings County,2351,3271,2529,2381,0,2260,91,30,148,148,0,120,28,0,742,560,0,469,91,182,212,6.5,1.3,0.0,24.5,294874.19140625,2206.12378399216
48643,11217,11217,36047018100,169373,0,Census Tract 181,New York,Kings County,2351,3271,2529,2381,0,2260,91,30,148,148,0,120,28,0,742,560,0,469,91,182,212,6.5,1.3,0.0,24.5,294874.19140625,2206.12378399216
48643,11238,11238,36047018100,169373,0,Census Tract 181,New York,Kings County,2351,3271,2529,2381,0,2260,91,30,148,148,0,120,28,0,742,560,0,469,91,182,212,6.5,1.3,0.0,24.5,294874.19140625,2206.12378399216
48644,11214,11214,36047018200,165467,0,Census Tract 182,New York,Kings County,1728,2859,1886,1743,0,1638,90,15,143,143,0,143,0,0,973,811,0,785,26,162,177,6.2,0.9,0.0,16.6,287429.734375,2303.0890790015696
48645,11205,11205,36047018300,137311,0,Census Tract 183,New York,Kings County,1829,2276,1922,1829,0,1773,56,0,93,93,0,83,10,0,354,347,0,347,0,7,7,0.3,0.0,0.0,2.0,239079.2578125,1985.5991571236102
48646,11228,11228,36047018400,149131,0,Census Tract 184,New York,Kings County,1274,2222,1411,1307,0,1249,25,33,104,104,0,99,5,0,811,726,0,666,60,85,118,5.3,2.5,0.0,10.5,259060.66796875,2071.82398565703
48647,11205,11205,36047018501,111097,0,Census Tract 185.01,New York,Kings County,1531,3461,2040,1605,0,1491,40,74,435,396,0,371,25,39,1421,1121,0,796,325,300,413,11.9,4.6,9.0,21.1,193456.31640625,1778.26839086795
48648,11228,11228,36047018600,113058,0,Census Tract 186,New York,Kings County,1005,1765,1074,1022,0,955,50,17,52,52,0,49,3,0,691,611,0,533,78,80,97,5.5,1.7,0.0,11.6,196407.7421875,1879.7635512163397
48649,11205,11205,36047018700,85768,0,Census Tract 187,New York,Kings County,800,1263,885,812,0,761,39,12,73,73,0,73,0,0,378,294,0,235,59,84,96,7.6,1.5,0.0,22.2,149347.74609375,1569.7485638139901
48650,11204,11204,36047018800,175213,0,Census Tract 188,New York,Kings County,1345,2227,1416,1345,0,1288,57,0,71,71,0,71,0,0,811,713,0,629,84,98,98,4.4,0.0,0.0,12.1,304403.69140625,2356.09317006166
48650,11214,11214,36047018800,175213,0,Census Tract 188,New York,Kings County,1345,2227,1416,1345,0,1288,57,0,71,71,0,71,0,0,811,713,0,629,84,98,98,4.4,0.0,0.0,12.1,304403.69140625,2356.09317006166
48650,11228,11228,36047018800,175213,0,Census Tract 188,New York,Kings County,1345,2227,1416,1345,0,1288,57,0,71,71,0,71,0,0,811,713,0,629,84,98,98,4.4,0.0,0.0,12.1,304403.69140625,2356.09317006166
48651,11219,11219,36047019000,212933,0,Census Tract 190,New York,Kings County,2042,3811,2398,2129,0,2022,20,87,269,262,0,262,0,7,1413,1063,0,1034,29,350,444,11.7,4.1,2.6,24.8,369972.96875,2659.2090459589604
48651,11228,11228,36047019000,212933,0,Census Tract 190,New York,Kings County,2042,3811,2398,2129,0,2022,20,87,269,262,0,262,0,7,1413,1063,0,1034,29,350,444,11.7,4.1,2.6,24.8,369972.96875,2659.2090459589604
48652,11205,11205,36047019100,253798,0,Census Tract 191,New York,Kings County,1712,2212,1765,1722,0,1675,37,10,43,43,0,43,0,0,447,376,0,333,43,71,81,3.7,0.6,0.0,15.9,441955.25,3144.8758812480896
48653,11219,11219,36047019200,189790,0,Census Tract 192,New York,Kings County,1200,2139,1318,1276,0,1048,152,76,42,42,0,42,0,0,821,686,0,491,195,135,211,9.9,6.0,0.0,16.4,329835.7734375,2363.50275176281
48654,11205,11205,36047019300,269728,0,Census Tract 193,New York,Kings County,1655,3584,1912,1712,0,1576,79,57,200,200,0,187,13,0,1672,1177,0,984,193,495,552,15.4,3.3,0.0,29.6,469638.3515625,2808.24861665163
48654,11238,11238,36047019300,269728,0,Census Tract 193,New York,Kings County,1655,3584,1912,1712,0,1576,79,57,200,200,0,187,13,0,1672,1177,0,984,193,495,552,15.4,3.3,0.0,29.6,469638.3515625,2808.24861665163
48655,11219,11219,36047019400,178420,0,Census Tract 194,New York,Kings County,1709,3179,2071,1913,0,1577,132,204,158,91,0,63,28,67,1108,861,0,719,142,247,518,16.3,10.7,42.4,22.3,310051.6328125,2499.70882691432
48656,11205,11205,36047019500,137021,0,Census Tract 195,New York,Kings County,2547,3379,2626,2558,0,2464,83,11,68,68,0,68,0,0,753,692,0,620,72,61,72,2.1,0.4,0.0,8.1,238573.6796875,1966.05038984495
48657,11219,11219,36047019600,188307,0,Census Tract 196,New York,Kings County,1428,2955,1848,1596,0,1245,183,168,252,252,0,174,78,0,1107,777,0,668,109,330,498,16.9,10.5,0.0,29.8,327210.375,2297.27579732705
48657,11228,11228,36047019600,188307,0,Census Tract 196,New York,Kings County,1428,2955,1848,1596,0,1245,183,168,252,252,0,174,78,0,1107,777,0,668,109,330,498,16.9,10.5,0.0,29.8,327210.375,2297.27579732705
48658,11205,11205,36047019700,169827,0,Census Tract 197,New York,Kings County,1973,3081,2209,2038,0,1936,37,65,171,171,0,139,32,0,872,696,0,618,78,176,241,7.8,3.2,0.0,20.2,295663.59765625,2471.37889570166
48658,11238,11238,36047019700,169827,0,Census Tract 197,New York,Kings County,1973,3081,2209,2038,0,1936,37,65,171,171,0,139,32,0,872,696,0,618,78,176,241,7.8,3.2,0.0,20.2,295663.59765625,2471.37889570166
48659,11228,11228,36047019800,134715,0,Census Tract 198,New York,Kings County,781,1430,809,788,0,773,8,7,21,21,0,21,0,0,621,533,20,468,45,88,95,6.6,0.9,0.0,14.2,234058.734375,2121.36793536679
48660,11238,11238,36047019900,188914,0,Census Tract 199,New York,Kings County,2239,2917,2370,2239,0,2122,117,0,131,121,0,110,11,10,547,369,17,256,96,178,188,6.4,0.0,7.6,32.5,328855.93359375,2402.01429656019
48661,11228,11228,36047020000,134858,0,Census Tract 200,New York,Kings County,1022,2007,1147,1064,11,992,19,42,83,83,0,77,6,0,860,749,10,702,37,111,153,7.6,3.9,0.0,12.9,234315.7734375,2121.95509213639
48662,11238,11238,36047020100,175379,0,Census Tract 201,New York,Kings County,2531,3246,2702,2531,0,2482,49,0,171,171,0,171,0,0,544,499,0,476,23,45,45,1.4,0.0,0.0,8.3,305293.19921875,2515.7426330519297
48663,11228,11228,36047020200,134828,0,Census Tract 202,New York,Kings County,867,1532,929,872,5,862,0,5,57,57,0,57,0,0,603,511,22,479,10,92,97,6.3,0.6,0.0,15.3,234274.28125,2122.22750571198
48664,11238,11238,36047020300,140848,0,Census Tract 203,New York,Kings County,1059,1517,1168,1072,0,1004,55,13,96,96,0,81,15,0,349,291,0,241,50,58,71,4.7,1.2,0.0,16.6,245154.07421875,2109.1314030416
48665,11228,11228,36047020400,134801,0,Census Tract 204,New York,Kings County,1007,1807,1135,1024,0,989,18,17,111,111,0,89,22,0,672,609,0,580,29,63,80,4.4,1.7,0.0,9.4,234234.65234375,2121.92155935413
48666,11238,11238,36047020500,159711,0,Census Tract 205,New York,Kings County,1975,2469,2083,2005,0,1887,88,30,78,78,0,78,0,0,386,386,9,369,8,0,30,1.2,1.5,0.0,0.0,277966.0703125,2187.6968201587197
48667,11228,11228,36047020600,170942,0,Census Tract 206,New York,Kings County,1227,2045,1293,1233,9,1169,49,6,60,56,3,53,0,4,752,698,4,670,24,54,64,3.1,0.5,6.7,7.2,297048.88671875,2381.46837675555
48668,11238,11238,36047020700,137888,0,Census Tract 207,New York,Kings County,2720,3822,2863,2800,15,2656,49,80,63,63,0,63,0,0,959,921,16,822,83,38,118,3.1,2.9,0.0,4.0,239968.2734375,2431.01625746625
48669,11228,11228,36047020800,143316,0,Census Tract 208,New York,Kings County,1406,2657,1577,1424,0,1326,80,18,153,142,0,142,0,11,1080,999,0,981,18,81,110,4.1,1.3,7.2,7.5,249050.5078125,2388.32786698633
48670,11219,11219,36047021000,150015,0,Census Tract 210,New York,Kings County,1776,3271,1878,1785,0,1689,87,9,93,93,0,93,0,0,1393,1152,18,1111,23,241,250,7.6,0.5,0.0,17.3,260704.61328125,2294.058676803
48671,11205,11205,36047021100,173676,0,Census Tract 211,New York,Kings County,981,1502,1069,996,0,928,53,15,73,73,0,59,14,0,433,326,0,319,7,107,122,8.1,1.5,0.0,24.7,302449.62890625,2941.6926878223303
48672,11219,11219,36047021200,190833,0,Census Tract 212,New York,Kings County,2201,3820,2467,2241,0,2061,140,40,226,226,0,220,6,0,1353,1190,0,1069,121,163,203,5.3,1.8,0.0,12.0,331658.82421875,2404.5962052803898
48673,11225,11225,36047021300,184156,0,Census Tract 213,New York,Kings County,2335,3606,2672,2362,22,2133,180,27,310,256,0,216,40,54,934,711,0,571,140,223,304,8.4,1.1,17.4,23.9,320423.2265625,2931.9775506535902
48674,11219,11219,36047021400,167965,0,Census Tract 214,New York,Kings County,866,1512,990,956,5,750,111,90,34,34,0,34,0,0,522,453,0,405,48,69,159,10.5,9.4,0.0,13.2,291932.03125,2230.32853246161
48675,11238,11238,36047021500,152318,0,Census Tract 215,New York,Kings County,3200,4609,3509,3200,0,2902,298,0,309,309,0,309,0,0,1100,1002,0,721,281,98,98,2.1,0.0,0.0,8.9,265066.41015625,2620.65334889137
48676,11219,11219,36047021600,168178,0,Census Tract 216,New York,Kings County,1147,2886,1496,1392,0,997,150,245,104,66,0,66,0,38,1390,1080,0,894,186,310,593,20.5,17.6,36.5,22.3,292310.546875,2494.58960122736
48677,11238,11238,36047021700,119678,0,Census Tract 217,New York,Kings County,2139,3185,2307,2148,0,2023,116,9,159,141,0,141,0,18,878,762,0,632,130,116,143,4.5,0.4,11.3,13.2,208262.20703125,1848.6024646724302
48678,11219,11219,36047021800,157820,0,Census Tract 218,New York,Kings County,630,1965,993,973,0,352,278,343,20,20,0,20,0,0,972,533,0,322,211,439,782,39.8,35.3,0.0,45.2,274325.53515625,2380.71967076016
48679,11216,11216,36047021900,147047,0,Census Tract 219,New York,Kings County,1999,3296,2104,2053,0,1925,74,54,51,51,0,51,0,0,1192,968,0,816,152,224,278,8.4,2.6,0.0,18.8,255884.6640625,2023.28864176124
48679,11238,11238,36047021900,147047,0,Census Tract 219,New York,Kings County,1999,3296,2104,2053,0,1925,74,54,51,51,0,51,0,0,1192,968,0,816,152,224,278,8.4,2.6,0.0,18.8,255884.6640625,2023.28864176124
48680,11219,11219,36047022000,194279,0,Census Tract 220,New York,Kings County,991,2599,1399,1286,0,634,357,295,113,52,0,52,0,61,1200,651,0,449,202,549,905,34.8,22.9,54.0,45.8,337715.29296875,2457.7991586459502
48681,11216,11216,36047022100,152083,0,Census Tract 221,New York,Kings County,2243,3231,2462,2367,0,2065,178,124,95,78,0,63,15,17,769,546,9,487,50,223,364,11.3,5.2,17.9,29.0,264678.8125,2241.34273989978
48681,11238,11238,36047022100,152083,0,Census Tract 221,New York,Kings County,2243,3231,2462,2367,0,2065,178,124,95,78,0,63,15,17,769,546,9,487,50,223,364,11.3,5.2,17.9,29.0,264678.8125,2241.34273989978
48682,11219,11219,36047022200,176184,0,Census Tract 222,New York,Kings County,938,2386,1272,1213,0,572,366,275,59,59,0,42,17,0,1114,687,0,354,333,427,702,29.4,22.7,0.0,38.3,306279.5078125,2306.8834864076002
48683,11218,11218,36047022400,175564,0,Census Tract 224,New York,Kings County,1685,3276,2251,2205,0,1331,354,520,46,46,0,21,25,0,1025,687,0,504,183,338,858,26.2,23.6,0.0,33.0,305221.01953125,2346.27167061143
48683,11219,11219,36047022400,175564,0,Census Tract 224,New York,Kings County,1685,3276,2251,2205,0,1331,354,520,46,46,0,21,25,0,1025,687,0,504,183,338,858,26.2,23.6,0.0,33.0,305221.01953125,2346.27167061143
48684,11218,11218,36047022600,156180,0,Census Tract 226,New York,Kings County,917,1428,1046,993,0,746,171,76,53,53,0,43,10,0,382,341,0,277,64,41,117,8.2,7.7,0.0,10.7,271535.08203125,2392.38356953537
48685,11216,11216,36047022700,240700,0,Census Tract 227,New York,Kings County,2120,3130,2404,2280,0,1939,181,160,124,110,0,59,51,14,726,598,0,484,114,128,302,9.6,7.0,11.3,17.6,418972.7578125,2738.03314693947
48685,11238,11238,36047022700,240700,0,Census Tract 227,New York,Kings County,2120,3130,2404,2280,0,1939,181,160,124,110,0,59,51,14,726,598,0,484,114,128,302,9.6,7.0,11.3,17.6,418972.7578125,2738.03314693947
48686,11218,11218,36047022800,167373,0,Census Tract 228,New York,Kings County,837,2279,1216,1159,0,646,191,322,57,48,0,42,6,9,1063,674,0,427,247,389,720,31.6,27.8,15.8,36.6,290971.0546875,2428.5665063448
48687,11216,11216,36047022900,171832,0,Census Tract 229,New York,Kings County,2296,3250,2521,2428,29,2215,52,132,93,93,0,93,0,0,729,502,14,274,214,227,359,11.0,5.4,0.0,31.1,299129.7265625,2188.23033712013
48687,11238,11238,36047022900,171832,0,Census Tract 229,New York,Kings County,2296,3250,2521,2428,29,2215,52,132,93,93,0,93,0,0,729,502,14,274,214,227,359,11.0,5.4,0.0,31.1,299129.7265625,2188.23033712013
48688,11218,11218,36047023000,150951,0,Census Tract 230,New York,Kings County,1127,2231,1420,1355,0,734,393,228,65,10,0,0,10,55,811,432,0,264,168,379,662,29.7,16.8,84.6,46.7,262407.76171875,3344.5722577786896
48688,11219,11219,36047023000,150951,0,Census Tract 230,New York,Kings County,1127,2231,1420,1355,0,734,393,228,65,10,0,0,10,55,811,432,0,264,168,379,662,29.7,16.8,84.6,46.7,262407.76171875,3344.5722577786896
48689,11238,11238,36047023100,159414,0,Census Tract 231,New York,Kings County,2166,3177,2359,2234,0,1986,180,68,125,125,0,125,0,0,818,630,0,530,100,188,256,8.1,3.0,0.0,23.0,277517.73828125,2378.30140852049
48690,11218,11218,36047023200,226367,0,Census Tract 232,New York,Kings County,1425,3200,1877,1830,101,943,381,405,47,47,0,47,0,0,1323,878,65,534,279,445,850,26.6,22.1,0.0,33.6,393492.31640625,2926.9975853647197
48690,11219,11219,36047023200,226367,0,Census Tract 232,New York,Kings County,1425,3200,1877,1830,101,943,381,405,47,47,0,47,0,0,1323,878,65,534,279,445,850,26.6,22.1,0.0,33.6,393492.31640625,2926.9975853647197
48691,11205,11205,36047023300,171841,0,Census Tract 233,New York,Kings County,2696,4145,3065,2793,0,2353,343,97,272,272,0,141,131,0,1080,814,0,646,168,266,363,8.8,3.5,0.0,24.6,299177.44921875,2187.29357452026
48691,11216,11216,36047023300,171841,0,Census Tract 233,New York,Kings County,2696,4145,3065,2793,0,2353,343,97,272,272,0,141,131,0,1080,814,0,646,168,266,363,8.8,3.5,0.0,24.6,299177.44921875,2187.29357452026
48691,11238,11238,36047023300,171841,0,Census Tract 233,New York,Kings County,2696,4145,3065,2793,0,2353,343,97,272,272,0,141,131,0,1080,814,0,646,168,266,363,8.8,3.5,0.0,24.6,299177.44921875,2187.29357452026
48692,11219,11219,36047023400,169784,0,Census Tract 234,New York,Kings County,830,2380,1323,1274,0,457,373,444,49,35,0,28,7,14,1057,679,28,437,214,378,836,35.1,34.9,28.6,35.8,295116.265625,2507.698449163
48693,11205,11205,36047023500,141574,0,Census Tract 235,New York,Kings County,1755,2796,2022,1955,0,1518,237,200,67,67,0,67,0,0,774,582,0,465,117,192,392,14.0,10.2,0.0,24.8,246510.78515625,1994.29176620638
48694,11219,11219,36047023600,169852,0,Census Tract 236,New York,Kings County,974,3219,1724,1630,0,472,502,656,94,57,0,33,24,37,1495,934,0,456,478,561,1254,39.0,40.2,39.4,37.5,295216.5,2508.44165689715
48695,11219,11219,36047023800,169884,0,Census Tract 238,New York,Kings County,1078,2488,1457,1371,0,734,344,293,86,49,0,14,35,37,1031,545,0,322,223,486,816,32.8,21.4,43.0,47.1,295258.28515625,2508.4306404069002
48696,11219,11219,36047024000,169751,0,Census Tract 240,New York,Kings County,1056,2893,1454,1384,0,882,174,328,70,59,0,49,10,11,1439,884,0,500,384,555,894,30.9,23.7,15.7,38.6,295013.34375,2506.86073388144
48697,11205,11205,36047024100,180215,0,Census Tract 241,New York,Kings County,1369,2085,1664,1553,0,1244,125,184,111,111,0,72,39,0,421,300,0,233,67,121,305,14.6,11.8,0.0,28.7,313789.765625,2349.00696901924
48698,11204,11204,36047024200,191453,0,Census Tract 242,New York,Kings County,950,1807,1117,1048,0,792,158,98,69,58,0,52,6,11,690,595,10,438,147,95,204,11.3,9.4,15.9,13.8,332693.88671875,2798.0354266014897
48698,11219,11219,36047024200,191453,0,Census Tract 242,New York,Kings County,950,1807,1117,1048,0,792,158,98,69,58,0,52,6,11,690,595,10,438,147,95,204,11.3,9.4,15.9,13.8,332693.88671875,2798.0354266014897
48699,11205,11205,36047024300,154349,0,Census Tract 243,New York,Kings County,2138,3532,2374,2160,0,1994,144,22,214,193,0,193,0,21,1158,807,0,714,93,351,394,11.2,1.0,9.8,30.3,268712.34375,2129.10353682111
48699,11216,11216,36047024300,154349,0,Census Tract 243,New York,Kings County,2138,3532,2374,2160,0,1994,144,22,214,193,0,193,0,21,1158,807,0,714,93,351,394,11.2,1.0,9.8,30.3,268712.34375,2129.10353682111
48700,11204,11204,36047024400,155278,0,Census Tract 244,New York,Kings County,1165,2349,1311,1254,0,924,241,89,57,57,0,37,20,0,1038,872,0,712,160,166,255,10.9,7.1,0.0,16.0,269805.60546875,2522.44858781975
48701,11216,11216,36047024500,166849,0,Census Tract 245,New York,Kings County,2455,3764,2697,2500,0,2224,231,45,197,170,0,170,0,27,1067,848,0,699,149,219,291,7.7,1.8,13.7,20.5,290437.62890625,2246.05348935109
48702,11204,11204,36047024600,172880,0,Census Tract 246,New York,Kings County,1106,2181,1300,1177,0,1003,103,71,123,109,0,104,5,14,881,670,4,615,51,211,296,13.6,6.0,11.4,24.0,300357.44921875,2725.09977642229
48703,11216,11216,36047024700,179739,0,Census Tract 247,New York,Kings County,1347,2118,1460,1360,12,1221,114,13,100,57,0,50,7,43,658,538,0,450,88,120,176,8.3,1.0,43.0,18.2,312842.546875,2987.5957267254603
48704,11204,11204,36047024800,176029,0,Census Tract 248,New York,Kings County,1258,2121,1348,1296,0,1165,93,38,52,52,0,52,0,0,773,667,0,605,62,106,144,6.8,2.9,0.0,13.7,305854.25,2577.61189239198
48705,11216,11216,36047024900,168496,0,Census Tract 249,New York,Kings County,2570,3776,2855,2636,0,2339,231,66,219,219,0,195,24,0,921,758,0,631,127,163,229,6.1,2.5,0.0,17.7,293303.22265625,2325.35773238065
48706,11219,11219,36047025000,173505,0,Census Tract 250,New York,Kings County,950,1524,1025,958,24,924,2,8,67,67,0,67,0,0,499,404,21,383,0,95,103,6.8,0.8,0.0,19.0,301493.64453125,2387.0496590489397
48707,11216,11216,36047025100,138489,0,Census Tract 251,New York,Kings County,1482,2934,1701,1493,0,1466,16,11,208,136,0,136,0,72,1233,899,0,840,59,334,417,14.2,0.7,34.6,27.1,241103.94921875,2044.02646750377
48708,11204,11204,36047025200,181275,0,Census Tract 252,New York,Kings County,2164,4005,2547,2279,0,2043,121,115,268,260,0,199,61,8,1458,1209,0,1153,56,249,372,9.3,5.0,3.0,17.1,314956.12109375,2685.72772046621
48709,11206,11206,36047025300,161836,0,Census Tract 253,New York,Kings County,1614,2788,1898,1737,25,1589,0,123,161,161,0,161,0,0,890,734,0,708,26,156,279,10.0,7.1,0.0,17.5,281791.94921875,2264.47236209382
48709,11216,11216,36047025300,161836,0,Census Tract 253,New York,Kings County,1614,2788,1898,1737,25,1589,0,123,161,161,0,161,0,0,890,734,0,708,26,156,279,10.0,7.1,0.0,17.5,281791.94921875,2264.47236209382
48710,11204,11204,36047025400,175492,0,Census Tract 254,New York,Kings County,1580,3233,1890,1673,0,1464,116,93,217,217,0,191,26,0,1343,1043,0,896,147,300,393,12.2,5.6,0.0,22.3,304882.75,2531.5354409430497
48711,11206,11206,36047025500,138635,0,Census Tract 255,New York,Kings County,1711,4019,2244,1890,55,1424,232,179,354,329,8,267,54,25,1775,1303,25,1107,171,472,676,16.8,9.5,7.1,26.6,241430.265625,2047.83413372371
48712,11204,11204,36047025600,173279,0,Census Tract 256,New York,Kings County,1196,2349,1360,1240,0,1140,56,44,120,120,0,120,0,0,989,745,0,692,53,244,288,12.3,3.5,0.0,24.7,301022.140625,2529.82306483179
48713,11206,11206,36047025700,181113,0,Census Tract 257,New York,Kings County,1019,1598,1152,1062,0,979,40,43,90,64,0,64,0,26,446,374,0,356,18,72,141,8.8,4.0,28.9,16.1,315411.66015625,2591.00849191263
48714,11204,11204,36047025800,170222,0,Census Tract 258,New York,Kings County,2033,3590,2172,2064,0,1992,41,31,108,86,0,86,0,22,1418,1150,0,1083,67,268,321,8.9,1.5,20.4,18.9,295695.84375,2513.3622338235896
48715,11206,11206,36047025901,80237,0,Census Tract 259.01,New York,Kings County,1013,1778,1252,1126,0,894,119,113,126,113,0,101,12,13,526,420,0,404,16,106,232,13.0,10.0,10.3,20.2,139719.703125,1715.43380020026
48716,11206,11206,36047025902,59594,0,Census Tract 259.02,New York,Kings County,821,2403,1089,887,0,678,143,66,202,189,0,142,47,13,1314,1013,0,839,174,301,380,15.8,7.4,6.4,22.9,103779.28515625,1291.8418341801
48717,11204,11204,36047026000,162864,0,Census Tract 260,New York,Kings County,1399,2804,1570,1416,24,1291,84,17,154,146,0,124,22,8,1234,1023,15,896,112,211,236,8.4,1.2,5.2,17.1,282945.09765625,2289.5391996285503
48718,11206,11206,36047026100,199418,0,Census Tract 261,New York,Kings County,2586,4041,2749,2653,0,2414,172,67,96,96,0,96,0,0,1292,1024,0,949,75,268,335,8.3,2.5,0.0,20.7,347227.953125,2364.93705399269
48718,11216,11216,36047026100,199418,0,Census Tract 261,New York,Kings County,2586,4041,2749,2653,0,2414,172,67,96,96,0,96,0,0,1292,1024,0,949,75,268,335,8.3,2.5,0.0,20.7,347227.953125,2364.93705399269
48718,11221,11221,36047026100,199418,0,Census Tract 261,New York,Kings County,2586,4041,2749,2653,0,2414,172,67,96,96,0,96,0,0,1292,1024,0,949,75,268,335,8.3,2.5,0.0,20.7,347227.953125,2364.93705399269
48719,11204,11204,36047026200,157859,0,Census Tract 262,New York,Kings County,1001,1994,1257,1110,0,930,71,109,147,142,0,139,3,5,737,645,11,549,85,92,206,10.3,9.8,3.4,12.5,274264.25,2164.17990293785
48719,11219,11219,36047026200,157859,0,Census Tract 262,New York,Kings County,1001,1994,1257,1110,0,930,71,109,147,142,0,139,3,5,737,645,11,549,85,92,206,10.3,9.8,3.4,12.5,274264.25,2164.17990293785
48719,11228,11228,36047026200,157859,0,Census Tract 262,New York,Kings County,1001,1994,1257,1110,0,930,71,109,147,142,0,139,3,5,737,645,11,549,85,92,206,10.3,9.8,3.4,12.5,274264.25,2164.17990293785
48720,11216,11216,36047026300,119604,0,Census Tract 263,New York,Kings County,949,1565,1057,965,0,865,84,16,92,63,0,63,0,29,508,364,0,257,107,144,189,12.1,1.7,31.5,28.3,208238.98046875,1929.17052200314
48720,11221,11221,36047026300,119604,0,Census Tract 263,New York,Kings County,949,1565,1057,965,0,865,84,16,92,63,0,63,0,29,508,364,0,257,107,144,189,12.1,1.7,31.5,28.3,208238.98046875,1929.17052200314
48721,11204,11204,36047026400,189454,0,Census Tract 264,New York,Kings County,2378,4028,2611,2484,0,2225,153,106,127,106,0,99,7,21,1417,1298,19,1170,109,119,246,6.1,4.3,16.5,8.4,329120.828125,2851.9038567787
48721,11214,11214,36047026400,189454,0,Census Tract 264,New York,Kings County,2378,4028,2611,2484,0,2225,153,106,127,106,0,99,7,21,1417,1298,19,1170,109,119,246,6.1,4.3,16.5,8.4,329120.828125,2851.9038567787
48722,11216,11216,36047026500,159608,0,Census Tract 265,New York,Kings County,1939,3207,2155,2005,35,1769,135,66,150,150,21,87,42,0,1052,835,0,763,72,217,283,8.8,3.3,0.0,20.6,277866.078125,2147.7029746091503
48722,11221,11221,36047026500,159608,0,Census Tract 265,New York,Kings County,1939,3207,2155,2005,35,1769,135,66,150,150,21,87,42,0,1052,835,0,763,72,217,283,8.8,3.3,0.0,20.6,277866.078125,2147.7029746091503
48723,11204,11204,36047026600,165897,0,Census Tract 266,New York,Kings County,1615,2855,1768,1643,0,1562,53,28,125,125,0,110,15,0,1087,990,0,921,69,97,125,4.4,1.7,0.0,8.9,288176.95703125,3095.34926575127
48724,11216,11216,36047026700,159562,0,Census Tract 267,New York,Kings County,1921,3421,2283,2003,0,1750,171,82,280,267,0,216,51,13,1138,938,0,769,169,200,295,8.6,4.1,4.6,17.6,277760.71484375,2146.8373488504003
48724,11221,11221,36047026700,159562,0,Census Tract 267,New York,Kings County,1921,3421,2283,2003,0,1750,171,82,280,267,0,216,51,13,1138,938,0,769,169,200,295,8.6,4.1,4.6,17.6,277760.71484375,2146.8373488504003
48725,11204,11204,36047026800,178969,0,Census Tract 268,New York,Kings County,1858,3133,2070,1918,0,1791,67,60,152,152,0,137,15,0,1063,917,0,901,16,146,206,6.6,3.1,0.0,13.7,310863.9296875,2545.8502774527
48725,11214,11214,36047026800,178969,0,Census Tract 268,New York,Kings County,1858,3133,2070,1918,0,1791,67,60,152,152,0,137,15,0,1063,917,0,901,16,146,206,6.6,3.1,0.0,13.7,310863.9296875,2545.8502774527
48726,11216,11216,36047026900,133946,0,Census Tract 269,New York,Kings County,1606,2529,1826,1680,0,1526,80,74,146,135,0,126,9,11,703,555,0,504,51,148,233,9.2,4.4,7.5,21.1,233151.09765625,2029.85013876573
48727,11214,11214,36047027000,134003,0,Census Tract 270,New York,Kings County,1066,1798,1118,1086,27,977,62,20,32,32,0,32,0,0,680,465,7,408,50,215,235,13.1,1.8,0.0,31.6,232729.97265625,2112.50107326728
48728,11213,11213,36047027100,245356,0,Census Tract 271,New York,Kings County,1294,2131,1484,1313,0,1216,78,19,171,171,0,139,32,0,647,533,0,481,52,114,133,6.2,1.4,0.0,17.6,427044.94140625,3784.6871769089003
48728,11216,11216,36047027100,245356,0,Census Tract 271,New York,Kings County,1294,2131,1484,1313,0,1216,78,19,171,171,0,139,32,0,647,533,0,481,52,114,133,6.2,1.4,0.0,17.6,427044.94140625,3784.6871769089003
48729,11214,11214,36047027200,132147,0,Census Tract 272,New York,Kings County,1664,2938,1816,1714,0,1631,33,50,102,102,0,102,0,0,1122,933,0,867,66,189,239,8.1,2.9,0.0,16.8,229521.18359375,2931.86138837047
48730,11216,11216,36047027300,149700,0,Census Tract 273,New York,Kings County,1336,2722,1508,1412,0,1211,125,76,96,65,0,46,19,31,1214,1097,0,856,241,117,224,8.2,5.4,32.3,9.6,260571.09375,2119.4010723680803
48730,11233,11233,36047027300,149700,0,Census Tract 273,New York,Kings County,1336,2722,1508,1412,0,1211,125,76,96,65,0,46,19,31,1214,1097,0,856,241,117,224,8.2,5.4,32.3,9.6,260571.09375,2119.4010723680803
48731,11204,11204,36047027400,163366,0,Census Tract 274,New York,Kings County,1480,2663,1584,1519,4,1427,49,39,65,65,0,65,0,0,1079,912,7,832,73,167,206,7.7,2.6,0.0,15.5,283764.8203125,2480.95869884738
48731,11214,11214,36047027400,163366,0,Census Tract 274,New York,Kings County,1480,2663,1584,1519,4,1427,49,39,65,65,0,65,0,0,1079,912,7,832,73,167,206,7.7,2.6,0.0,15.5,283764.8203125,2480.95869884738
48732,11216,11216,36047027500,162078,0,Census Tract 275,New York,Kings County,2217,3522,2419,2285,17,2096,104,68,134,122,0,93,29,12,1103,990,0,862,128,113,193,5.5,3.0,9.0,10.2,282141.078125,2167.20590688739
48732,11221,11221,36047027500,162078,0,Census Tract 275,New York,Kings County,2217,3522,2419,2285,17,2096,104,68,134,122,0,93,29,12,1103,990,0,862,128,113,193,5.5,3.0,9.0,10.2,282141.078125,2167.20590688739
48732,11233,11233,36047027500,162078,0,Census Tract 275,New York,Kings County,2217,3522,2419,2285,17,2096,104,68,134,122,0,93,29,12,1103,990,0,862,128,113,193,5.5,3.0,9.0,10.2,282141.078125,2167.20590688739
48733,11214,11214,36047027600,149396,0,Census Tract 276,New York,Kings County,2031,3199,2224,2108,0,1851,180,77,116,100,0,88,12,16,975,801,0,730,71,174,267,8.3,3.7,13.8,17.8,259498.80859375,2515.06188194198
48734,11221,11221,36047027700,162108,0,Census Tract 277,New York,Kings County,1779,3772,2289,1930,0,1562,217,151,359,270,0,257,13,89,1483,1190,0,973,217,293,533,14.1,7.8,24.8,19.8,282215.82421875,2167.50808788379
48735,11214,11214,36047027800,160472,0,Census Tract 278,New York,Kings County,1629,2892,1902,1671,0,1425,204,42,231,231,0,231,0,0,990,813,0,742,71,177,219,7.6,2.5,0.0,17.9,278706.33203125,2452.01784326485
48736,11221,11221,36047027900,161924,0,Census Tract 279,New York,Kings County,1892,3095,2041,1954,0,1547,345,62,87,87,0,87,0,0,1054,790,0,703,87,264,326,10.5,3.2,0.0,25.0,281918.234375,2166.74285745633
48737,11214,11214,36047028000,139723,55041,Census Tract 280,New York,Kings County,878,1484,958,905,0,847,31,27,53,48,0,48,0,5,526,430,0,421,9,96,128,8.6,3.0,9.4,18.3,253220.796875,2552.58617889557
48738,11206,11206,36047028100,161938,0,Census Tract 281,New York,Kings County,1838,3364,2105,1880,0,1732,106,42,225,176,0,120,56,49,1259,922,0,855,67,337,428,12.7,2.2,21.8,26.8,281970.44140625,2166.77447776274
48738,11221,11221,36047028100,161938,0,Census Tract 281,New York,Kings County,1838,3364,2105,1880,0,1732,106,42,225,176,0,120,56,49,1259,922,0,855,67,337,428,12.7,2.2,21.8,26.8,281970.44140625,2166.77447776274
48739,11214,11214,36047028200,169389,73215,Census Tract 282,New York,Kings County,1569,2803,1737,1639,0,1541,28,70,98,98,0,90,8,0,1066,999,0,969,30,67,137,4.9,4.3,0.0,6.3,311254.54296875,2604.97325992076
48740,11206,11206,36047028300,121875,0,Census Tract 283,New York,Kings County,1343,3066,1785,1491,0,1229,114,148,294,208,0,141,67,86,1281,1094,66,811,217,187,421,13.7,9.9,29.3,14.6,212229.5703125,1949.1481286249398
48741,11214,11214,36047028400,164257,0,Census Tract 284,New York,Kings County,1498,2797,1712,1612,0,1413,85,114,100,100,0,78,22,0,1085,854,0,762,92,231,345,12.3,7.1,0.0,21.3,285267.7265625,2448.94739326029
48742,11206,11206,36047028501,83218,0,Census Tract 285.01,New York,Kings County,263,367,299,277,0,190,73,14,22,22,0,22,0,0,68,64,0,43,21,4,18,4.9,5.1,0.0,5.9,144932.57421875,1675.1197374760998
48743,11206,11206,36047028502,119870,0,Census Tract 285.02,New York,Kings County,1009,2386,1339,1097,26,859,124,88,242,205,0,177,28,37,1047,688,27,411,250,359,484,20.3,8.0,15.3,34.3,208749.67578125,1919.5394007722698
48744,11214,11214,36047028600,176618,58184,Census Tract 286,New York,Kings County,2248,3795,2340,2248,0,2084,164,0,92,92,0,75,17,0,1455,1054,18,799,237,401,401,10.6,0.0,0.0,27.6,313050.140625,2644.40199822996
48745,11206,11206,36047028700,148810,0,Census Tract 287,New York,Kings County,1235,2677,1372,1294,0,1092,143,59,78,56,0,56,0,22,1305,905,0,743,162,400,481,18.0,4.6,28.2,30.7,259133.73828125,2381.56179329518
48745,11221,11221,36047028700,148810,0,Census Tract 287,New York,Kings County,1235,2677,1372,1294,0,1092,143,59,78,56,0,56,0,22,1305,905,0,743,162,400,481,18.0,4.6,28.2,30.7,259133.73828125,2381.56179329518
48746,11214,11214,36047028800,152808,0,Census Tract 288,New York,Kings County,1723,2863,1799,1729,0,1605,118,6,70,70,0,70,0,0,1064,912,0,829,83,152,158,5.5,0.3,0.0,14.3,265375.5625,2321.2527546372603
48747,11206,11206,36047028900,165740,0,Census Tract 289,New York,Kings County,1605,3098,1931,1679,0,1453,152,74,252,146,0,137,9,106,1167,860,0,744,116,307,487,15.7,4.4,42.1,26.3,288594.49609375,2640.9397775309803
48747,11221,11221,36047028900,165740,0,Census Tract 289,New York,Kings County,1605,3098,1931,1679,0,1453,152,74,252,146,0,137,9,106,1167,860,0,744,116,307,487,15.7,4.4,42.1,26.3,288594.49609375,2640.9397775309803
48748,11214,11214,36047029000,154712,0,Census Tract 290,New York,Kings County,1920,3253,2081,2027,0,1656,264,107,54,54,0,19,35,0,1172,918,0,691,227,254,361,11.1,5.3,0.0,21.7,268669.89453125,2329.83621481232
48749,11221,11221,36047029100,164644,0,Census Tract 291,New York,Kings County,1719,2639,1917,1719,24,1658,37,0,198,155,0,155,0,43,722,570,0,502,68,152,195,7.4,0.0,21.7,21.1,286663.33203125,2187.0046558636104
48750,11214,11214,36047029200,205508,91737,Census Tract 292,New York,Kings County,1223,2234,1343,1256,0,1158,65,33,87,80,0,80,0,7,891,775,0,724,51,116,156,7.0,2.6,8.0,13.0,347822.77734375,2904.81983960336
48751,11221,11221,36047029300,164460,0,Census Tract 293,New York,Kings County,1300,2702,1794,1518,0,1212,88,218,276,221,0,221,0,55,908,622,0,545,77,286,559,20.7,14.4,19.9,31.5,286318.515625,2186.27966752785
48752,11214,11214,36047029400,188664,63389,Census Tract 294,New York,Kings County,759,1379,889,814,0,658,101,55,75,75,0,55,20,0,490,342,0,326,16,148,203,14.7,6.8,0.0,30.2,322044.6484375,2611.9254680408803
48753,11221,11221,36047029500,164586,0,Census Tract 295,New York,Kings County,2393,3625,2574,2447,0,2185,208,54,127,127,0,127,0,0,1051,1001,0,816,185,50,104,2.9,2.2,0.0,4.8,286508.01953125,2185.9461977219603
48753,11233,11233,36047029500,164586,0,Census Tract 295,New York,Kings County,2393,3625,2574,2447,0,2185,208,54,127,127,0,127,0,0,1051,1001,0,816,185,50,104,2.9,2.2,0.0,4.8,286508.01953125,2185.9461977219603
48754,11214,11214,36047029600,214120,0,Census Tract 296,New York,Kings County,2401,4516,2745,2540,0,2272,129,139,205,205,0,169,36,0,1771,1519,0,1345,174,252,391,8.7,5.5,0.0,14.2,371815.9921875,2979.3530975542894
48755,11233,11233,36047029700,205561,0,Census Tract 297,New York,Kings County,2274,3651,2384,2298,0,2088,186,24,86,86,0,75,11,0,1267,1196,0,1045,151,71,95,2.6,1.0,0.0,5.6,357807.93359375,2355.5352847137
48756,11214,11214,36047029800,220827,0,Census Tract 298,New York,Kings County,1832,2913,1892,1832,9,1739,84,0,60,60,0,37,23,0,1021,871,9,763,99,150,150,5.1,0.0,0.0,14.7,383461.27734375,2986.8051680061103
48756,11223,11223,36047029800,220827,0,Census Tract 298,New York,Kings County,1832,2913,1892,1832,9,1739,84,0,60,60,0,37,23,0,1021,871,9,763,99,150,150,5.1,0.0,0.0,14.7,383461.27734375,2986.8051680061103
48757,11233,11233,36047029900,142218,0,Census Tract 299,New York,Kings County,1058,2008,1205,1120,0,883,175,62,85,85,0,85,0,0,803,729,0,588,141,74,136,6.8,5.5,0.0,9.2,247526.68359375,2354.2718881852898
48758,11214,11214,36047030000,195051,0,Census Tract 300,New York,Kings County,1842,3372,1992,1871,19,1823,0,29,121,121,0,121,0,0,1380,1019,26,914,79,361,390,11.6,1.5,0.0,26.2,338667.4140625,2909.2776398626397
48759,11233,11233,36047030100,194432,0,Census Tract 301,New York,Kings County,1159,2370,1326,1169,0,860,299,10,157,136,0,105,31,21,1044,875,0,705,170,169,200,8.4,0.9,13.4,16.2,338395.484375,2983.886602315
48760,11214,11214,36047030200,211197,0,Census Tract 302,New York,Kings County,1972,3824,2150,2030,0,1844,128,58,120,101,0,91,10,19,1674,1521,0,1394,127,153,230,6.0,2.9,15.8,9.1,366681.2265625,2779.4568441673
48761,11233,11233,36047030300,253580,0,Census Tract 303,New York,Kings County,1665,3470,1973,1818,0,1486,179,153,155,145,0,145,0,10,1497,1243,0,902,341,254,417,12.0,8.4,6.5,17.0,441311.04296875,2784.50084828567
48762,11214,11214,36047030400,465276,362966,Census Tract 304,New York,Kings County,1595,3351,1801,1648,0,1550,45,53,153,153,0,153,0,0,1550,1247,14,1210,23,303,356,10.6,3.2,0.0,19.5,805725.12890625,6455.479322975029
48763,11238,11238,36047030500,322515,0,Census Tract 305,New York,Kings County,4103,5464,4304,4134,0,4016,87,31,170,145,0,129,16,25,1160,828,0,614,214,332,388,7.1,0.7,14.7,28.6,561313.546875,2966.6592084960903
48764,11214,11214,36047030600,193681,0,Census Tract 306,New York,Kings County,757,1372,844,778,0,672,85,21,66,54,0,48,6,12,528,418,0,336,82,110,143,10.4,2.7,18.2,20.8,336220.70703125,2448.02099566392
48765,11213,11213,36047030700,266959,0,Census Tract 307,New York,Kings County,1697,4049,2386,2067,0,1403,294,370,319,285,0,235,50,34,1663,1393,0,1135,258,270,674,16.6,17.9,10.7,16.2,464596.5703125,2878.0284450273602
48765,11233,11233,36047030700,266959,0,Census Tract 307,New York,Kings County,1697,4049,2386,2067,0,1403,294,370,319,285,0,235,50,34,1663,1393,0,1135,258,270,674,16.6,17.9,10.7,16.2,464596.5703125,2878.0284450273602
48766,11214,11214,36047030800,681580,0,Census Tract 308,New York,Kings County,746,1728,872,800,0,723,23,54,72,72,0,72,0,0,856,716,0,667,49,140,194,11.2,6.8,0.0,16.4,1183041.51953125,5115.86310929324
48766,11223,11223,36047030800,681580,0,Census Tract 308,New York,Kings County,746,1728,872,800,0,723,23,54,72,72,0,72,0,0,856,716,0,667,49,140,194,11.2,6.8,0.0,16.4,1183041.51953125,5115.86310929324
48767,11213,11213,36047030900,151863,0,Census Tract 309,New York,Kings County,977,1661,1117,1028,6,867,104,51,89,89,0,78,11,0,544,497,0,345,152,47,98,5.9,5.0,0.0,8.6,264297.68359375,2224.38539863833
48768,11213,11213,36047031100,152683,0,Census Tract 311,New York,Kings County,1435,2606,1690,1513,0,1189,246,78,177,155,0,124,31,22,916,807,0,493,314,109,209,8.0,5.2,12.4,11.9,265727.4609375,2224.5760011017396
48769,11213,11213,36047031300,174300,0,Census Tract 313,New York,Kings County,2415,3994,2604,2496,0,2211,204,81,108,89,0,71,18,19,1390,1188,0,1047,141,202,302,7.6,3.2,17.6,14.5,303349.30859375,2220.10294358672
48769,11216,11216,36047031300,174300,0,Census Tract 313,New York,Kings County,2415,3994,2604,2496,0,2211,204,81,108,89,0,71,18,19,1390,1188,0,1047,141,202,302,7.6,3.2,17.6,14.5,303349.30859375,2220.10294358672
48770,11214,11214,36047031400,835660,410549,Census Tract 314,New York,Kings County,2143,4330,2378,2208,0,2127,16,65,170,170,0,161,9,0,1952,1680,0,1359,321,272,337,7.8,2.9,0.0,13.9,1488394.5390625,7929.46571468121
48771,11216,11216,36047031500,180189,0,Census Tract 315,New York,Kings County,2796,4434,3115,2965,27,2603,166,169,150,150,0,98,52,0,1319,846,23,715,108,473,642,14.5,5.7,0.0,35.9,313602.703125,2302.46135380367
48772,11216,11216,36047031701,139741,0,Census Tract 317.01,New York,Kings County,2028,2875,2223,2066,0,1920,108,38,157,136,0,123,13,21,652,518,0,453,65,134,193,6.7,1.8,13.4,20.6,243184.7890625,2023.05018459254
48773,11216,11216,36047031702,139788,0,Census Tract 317.02,New York,Kings County,2050,2965,2231,2096,0,1833,217,46,135,135,0,114,21,0,734,555,0,534,21,179,225,7.6,2.2,0.0,24.4,243245.55859375,2023.43035480349
48774,11225,11225,36047031900,151344,0,Census Tract 319,New York,Kings County,1299,2468,1594,1423,0,1299,0,124,171,171,0,148,23,0,874,694,11,502,181,180,304,12.3,8.7,0.0,20.6,263321.05859375,2325.98156406025
48775,11225,11225,36047032100,160095,0,Census Tract 321,New York,Kings County,2799,4737,3285,3050,36,2604,159,251,235,149,0,149,0,86,1452,1023,32,879,112,429,766,16.2,8.2,36.6,29.5,278548.453125,2429.28358973358
48776,11225,11225,36047032300,173046,0,Census Tract 323,New York,Kings County,1869,3113,2100,1955,0,1725,144,86,145,121,0,107,14,24,1013,847,0,759,88,166,276,8.9,4.4,16.6,16.4,301077.33203125,2522.92082054621
48777,11225,11225,36047032500,168414,0,Census Tract 325,New York,Kings County,3569,5705,4050,3887,63,2880,626,318,163,163,0,124,39,0,1655,1309,18,1123,168,346,664,11.6,8.2,0.0,20.9,293026.64453125,2532.56159631952
48778,11224,11224,36047032600,329186,0,Census Tract 326,New York,Kings County,2003,5271,2806,2231,0,1570,433,228,575,509,17,400,92,66,2465,1943,32,1671,240,522,816,15.5,10.2,11.5,21.2,571211.16015625,3161.39965314856
48779,11225,11225,36047032700,177080,0,Census Tract 327,New York,Kings County,1321,2297,1646,1441,0,1168,153,120,205,146,0,146,0,59,651,520,0,425,95,131,310,13.5,8.3,28.8,20.1,308058.40625,2946.5135728782398
48780,11224,11224,36047032800,232840,0,Census Tract 328,New York,Kings County,974,2103,1251,1064,31,907,36,90,187,187,0,165,22,0,852,625,29,545,51,227,317,15.1,8.5,0.0,26.6,404026.703125,3060.04984478903
48781,11225,11225,36047032900,156418,0,Census Tract 329,New York,Kings County,2478,4591,2922,2726,0,2164,314,248,196,196,0,196,0,0,1669,1228,0,979,249,441,689,15.0,9.1,0.0,26.4,272120.32421875,2866.2427842131897
48782,11224,11224,36047033000,372139,119065,Census Tract 330,New York,Kings County,1444,4134,1830,1502,0,1385,59,58,328,236,0,193,43,92,2304,1698,0,1577,121,606,756,18.3,3.9,28.0,26.3,587513.07421875,3829.95384422831
48783,11213,11213,36047033100,142464,0,Census Tract 331,New York,Kings County,1735,3364,2230,1913,0,1620,115,178,317,297,0,255,42,20,1134,960,0,839,121,174,372,11.1,9.3,6.3,15.3,247849.66796875,3032.50274874243
48783,11225,11225,36047033100,142464,0,Census Tract 331,New York,Kings County,1735,3364,2230,1913,0,1620,115,178,317,297,0,255,42,20,1134,960,0,839,121,174,372,11.1,9.3,6.3,15.3,247849.66796875,3032.50274874243
48784,11213,11213,36047033300,186339,0,Census Tract 333,New York,Kings County,1517,3132,1690,1620,36,1274,207,103,70,59,0,41,18,11,1442,1311,69,930,312,131,245,7.8,6.4,15.7,9.1,324197.87890625,2997.06455393041
48784,11225,11225,36047033300,186339,0,Census Tract 333,New York,Kings County,1517,3132,1690,1620,36,1274,207,103,70,59,0,41,18,11,1442,1311,69,930,312,131,245,7.8,6.4,15.7,9.1,324197.87890625,2997.06455393041
48785,11213,11213,36047033500,180682,0,Census Tract 335,New York,Kings County,932,1977,1070,953,0,871,61,21,117,117,0,99,18,0,907,858,10,769,79,49,70,3.5,2.2,0.0,5.4,314372.65234375,2980.5798608646196
48786,11224,11224,36047033600,688235,1085724,Census Tract 336,New York,Kings County,2273,3703,2386,2311,0,2033,240,38,75,75,0,57,18,0,1317,1117,29,958,130,200,238,6.4,1.6,0.0,15.2,1175970.80078125,4444.85454536471
48787,11213,11213,36047033700,197587,0,Census Tract 337,New York,Kings County,1763,2965,1966,1936,0,1590,173,173,30,30,0,30,0,0,999,817,0,664,153,182,355,12.0,8.9,0.0,18.2,343803.453125,3030.0816907152002
48788,11213,11213,36047033900,180739,0,Census Tract 339,New York,Kings County,1970,3837,2209,2100,0,1857,113,130,109,109,0,109,0,0,1628,1050,0,901,149,578,708,18.5,6.2,0.0,35.5,314504.9453125,2979.4905151226003
48789,11224,11224,36047034000,129694,0,Census Tract 340,New York,Kings County,387,1221,472,409,5,327,55,22,63,48,0,48,0,15,749,478,42,386,50,271,308,25.2,5.4,23.8,36.2,225021.328125,2871.3242735955105
48790,11213,11213,36047034100,139771,0,Census Tract 341,New York,Kings County,1298,2251,1496,1427,0,1195,103,129,69,55,0,20,35,14,755,637,0,590,47,118,261,11.6,9.0,20.3,15.6,243234.3125,2021.8389965565198
48791,11224,11224,36047034200,229959,0,Census Tract 342,New York,Kings County,1148,4954,1564,1339,0,1132,16,191,225,208,0,208,0,17,3390,1827,26,1672,129,1563,1771,35.7,14.3,7.6,46.1,399000.3359375,2960.23529785581
48792,11213,11213,36047034300,162149,0,Census Tract 343,New York,Kings County,1806,3953,2164,1991,0,1666,140,185,173,173,0,155,18,0,1789,1406,0,1338,68,383,568,14.4,9.3,0.0,21.4,282176.38671875,2287.24975594424
48793,11213,11213,36047034500,163599,0,Census Tract 345,New York,Kings County,1426,2680,1575,1448,0,1365,61,22,127,127,0,127,0,0,1105,1068,0,867,201,37,59,2.2,1.5,0.0,3.3,284697.19921875,2285.221442271
48794,11213,11213,36047034700,139778,0,Census Tract 347,New York,Kings County,1565,3051,1902,1674,0,1383,182,109,228,217,0,164,53,11,1149,954,0,794,160,195,315,10.3,6.5,4.8,17.0,243238.45703125,2022.7756938390198
48795,11214,11214,36047034800,592737,87258,Census Tract 348,New York,Kings County,1332,2020,1444,1375,0,1267,65,43,69,69,0,67,2,0,576,568,0,560,8,8,51,2.5,3.1,0.0,1.4,1073423.51953125,7773.357516819391
48795,11224,11224,36047034800,592737,87258,Census Tract 348,New York,Kings County,1332,2020,1444,1375,0,1267,65,43,69,69,0,67,2,0,576,568,0,560,8,8,51,2.5,3.1,0.0,1.4,1073423.51953125,7773.357516819391
48796,11213,11213,36047034900,163213,0,Census Tract 349,New York,Kings County,2642,4638,3174,2794,0,2335,307,152,380,332,0,301,31,48,1464,1158,0,979,179,306,506,10.9,5.4,12.6,20.9,283982.203125,2454.04891106293
48797,11224,11224,36047035000,198572,0,Census Tract 350,New York,Kings County,1289,2806,1431,1378,0,1190,99,89,53,53,0,33,20,0,1375,971,0,901,70,404,493,17.6,6.5,0.0,29.4,344576.5703125,2370.6194638369398
48798,11213,11213,36047035100,163006,0,Census Tract 351,New York,Kings County,1971,3496,2289,2073,0,1776,195,102,216,216,0,162,54,0,1207,913,0,809,104,294,396,11.3,4.9,0.0,24.4,283625.98828125,2455.26249092033
48799,11224,11224,36047035200,990696,1400857,Census Tract 352,New York,Kings County,76,626,87,87,0,76,0,11,0,0,0,0,0,0,539,119,0,119,0,420,431,68.8,12.6,,77.9,1618346.6640625,12040.7546899172
48800,11213,11213,36047035300,163102,0,Census Tract 353,New York,Kings County,2577,4337,2925,2730,0,2435,142,153,195,186,0,166,20,9,1412,1160,0,918,242,252,414,9.5,5.6,4.6,17.8,283794.59765625,2454.44810571732
48801,11224,11224,36047035400,378037,0,Census Tract 354,New York,Kings County,2427,4815,2677,2578,0,2369,58,151,99,99,0,88,11,0,2138,1510,0,1385,125,628,779,16.2,5.9,0.0,29.4,656047.1640625,4567.44569694112
48801,11235,11235,36047035400,378037,0,Census Tract 354,New York,Kings County,2427,4815,2677,2578,0,2369,58,151,99,99,0,88,11,0,2138,1510,0,1385,125,628,779,16.2,5.9,0.0,29.4,656047.1640625,4567.44569694112
48802,11213,11213,36047035500,138408,0,Census Tract 355,New York,Kings County,2417,4144,2736,2513,0,2085,332,96,223,153,0,99,54,70,1408,1210,0,1005,205,198,364,8.8,3.8,31.4,14.1,240795.98046875,2360.18270452403
48803,11224,11224,36047035601,67906,0,Census Tract 356.01,New York,Kings County,1244,2846,1365,1259,0,1237,7,15,106,106,17,89,0,0,1481,1094,50,989,55,387,402,14.1,1.2,0.0,26.1,117848.0390625,1416.2425208320801
48804,11224,11224,36047035602,170787,0,Census Tract 356.02,New York,Kings County,2283,4687,2472,2372,0,2072,211,89,100,100,0,100,0,0,2215,1306,15,1203,88,909,998,21.3,3.8,0.0,41.0,296363.01953125,2293.4205899951003
48804,11235,11235,36047035602,170787,0,Census Tract 356.02,New York,Kings County,2283,4687,2472,2372,0,2072,211,89,100,100,0,100,0,0,2215,1306,15,1203,88,909,998,21.3,3.8,0.0,41.0,296363.01953125,2293.4205899951003
48805,11213,11213,36047035700,180064,0,Census Tract 357,New York,Kings County,973,1841,1204,1070,7,839,127,97,134,134,0,117,17,0,637,470,0,365,105,167,264,14.3,9.1,0.0,26.2,313300.890625,2574.82052080082
48806,11233,11233,36047035900,183572,0,Census Tract 359,New York,Kings County,1617,3821,2011,1822,0,1341,276,205,189,189,0,93,96,0,1810,1553,0,1146,407,257,462,12.1,11.3,0.0,14.2,319428.58203125,2640.02335034826
48807,11235,11235,36047036001,94811,0,Census Tract 360.01,New York,Kings County,942,2788,1210,1066,0,886,56,124,144,137,0,137,0,7,1578,816,0,698,118,762,893,32.0,11.6,4.9,48.3,164517.2890625,1767.91255635883
48808,11235,11235,36047036002,86032,0,Census Tract 360.02,New York,Kings County,1251,3583,1598,1394,0,1091,160,143,204,204,0,146,58,0,1985,1015,14,961,40,970,1113,31.1,10.3,0.0,48.9,149283.97265625,1554.40650937422
48809,11212,11212,36047036100,141044,0,Census Tract 361,New York,Kings County,917,1973,1007,974,0,813,104,57,33,33,0,33,0,0,966,732,0,481,251,234,291,14.7,5.9,0.0,24.2,245420.59765625,2452.62983672729
48809,11233,11233,36047036100,141044,0,Census Tract 361,New York,Kings County,917,1973,1007,974,0,813,104,57,33,33,0,33,0,0,966,732,0,481,251,234,291,14.7,5.9,0.0,24.2,245420.59765625,2452.62983672729
48810,11235,11235,36047036200,171110,0,Census Tract 362,New York,Kings County,1430,2604,1625,1500,14,1369,47,70,125,93,0,93,0,32,979,693,12,665,16,286,388,14.9,4.7,25.6,29.2,296926.71484375,2588.32854912932
48811,11212,11212,36047036300,259732,0,Census Tract 363,New York,Kings County,1677,3459,1928,1809,10,1295,372,132,119,119,0,69,50,0,1531,1307,9,1047,251,224,356,10.3,7.3,0.0,14.6,451970.62890625,3401.9986297917103
48811,11233,11233,36047036300,259732,0,Census Tract 363,New York,Kings County,1677,3459,1928,1809,10,1295,372,132,119,119,0,69,50,0,1531,1307,9,1047,251,224,356,10.3,7.3,0.0,14.6,451970.62890625,3401.9986297917103
48812,11235,11235,36047036400,143250,0,Census Tract 364,New York,Kings County,1063,1978,1253,1133,0,1009,54,70,120,120,0,120,0,0,725,578,0,531,47,147,217,11.0,6.2,0.0,20.3,248597.7421875,2421.61711206026
48813,11233,11233,36047036501,126351,0,Census Tract 365.01,New York,Kings County,1069,2458,1298,1228,0,942,127,159,70,55,0,41,14,15,1160,1079,0,942,137,81,255,10.4,12.9,21.4,7.0,219890.95703125,2193.34144618749
48814,11233,11233,36047036502,122049,0,Census Tract 365.02,New York,Kings County,392,758,473,460,0,362,30,68,13,5,0,5,0,8,285,227,0,204,23,58,134,17.7,14.8,61.5,20.4,212399.25,2496.1692563278602
48815,11235,11235,36047036600,234143,0,Census Tract 366,New York,Kings County,1817,3429,2040,1917,0,1660,157,100,123,114,0,114,0,9,1389,1150,0,1071,79,239,348,10.1,5.2,7.3,17.2,406367.69140625,2676.2277419952898
48816,11207,11207,36047036700,182968,0,Census Tract 367,New York,Kings County,639,1176,761,733,0,550,89,94,28,10,0,10,0,18,415,352,0,280,72,63,175,14.9,12.8,64.3,15.2,318442.8515625,2377.48865203758
48816,11233,11233,36047036700,182968,0,Census Tract 367,New York,Kings County,639,1176,761,733,0,550,89,94,28,10,0,10,0,18,415,352,0,280,72,63,175,14.9,12.8,64.3,15.2,318442.8515625,2377.48865203758
48817,11207,11207,36047036900,226736,0,Census Tract 369,New York,Kings County,2284,4297,2501,2383,0,1986,298,99,118,118,0,87,31,0,1796,1634,0,1197,437,162,261,6.1,4.2,0.0,9.0,394641.6171875,2897.95522536579
48817,11233,11233,36047036900,226736,0,Census Tract 369,New York,Kings County,2284,4297,2501,2383,0,1986,298,99,118,118,0,87,31,0,1796,1634,0,1197,437,162,261,6.1,4.2,0.0,9.0,394641.6171875,2897.95522536579
48818,11235,11235,36047037000,336242,0,Census Tract 370,New York,Kings County,1762,3541,2000,1921,0,1739,23,159,79,67,0,67,0,12,1541,1271,0,1264,7,270,441,12.5,8.3,15.2,17.5,583648.7109375,3146.55056298746
48819,11233,11233,36047037100,189347,0,Census Tract 371,New York,Kings County,1934,3473,2078,1984,19,1732,183,50,94,94,0,82,12,0,1395,1276,0,1130,146,119,169,4.9,2.5,0.0,8.5,329572.421875,2315.79945021594
48820,11233,11233,36047037300,170809,0,Census Tract 373,New York,Kings County,2129,3376,2310,2178,0,1887,242,49,132,132,0,74,58,0,1066,964,0,598,366,102,151,4.5,2.2,0.0,9.6,297339.33203125,2472.59922664281
48821,11223,11223,36047037401,225521,0,Census Tract 374.01,New York,Kings County,1867,3427,2063,1934,0,1843,24,67,129,129,0,129,0,0,1364,1063,19,995,49,301,368,10.7,3.5,0.0,22.1,391460.9921875,2806.32333424857
48821,11235,11235,36047037401,225521,0,Census Tract 374.01,New York,Kings County,1867,3427,2063,1934,0,1843,24,67,129,129,0,129,0,0,1364,1063,19,995,49,301,368,10.7,3.5,0.0,22.1,391460.9921875,2806.32333424857
48822,11223,11223,36047037402,301498,0,Census Tract 374.02,New York,Kings County,2414,4187,2683,2445,0,2266,148,31,238,238,0,123,115,0,1504,1101,0,1071,30,403,434,10.4,1.3,0.0,26.8,523328.93359375,3079.5947066107105
48823,11221,11221,36047037500,158802,0,Census Tract 375,New York,Kings County,1670,2604,1829,1688,0,1520,150,18,141,141,0,104,37,0,775,727,0,582,145,48,66,2.5,1.1,0.0,6.2,276467.95703125,2415.93083456897
48823,11233,11233,36047037500,158802,0,Census Tract 375,New York,Kings County,1670,2604,1829,1688,0,1520,150,18,141,141,0,104,37,0,775,727,0,582,145,48,66,2.5,1.1,0.0,6.2,276467.95703125,2415.93083456897
48824,11233,11233,36047037700,190208,0,Census Tract 377,New York,Kings County,1849,3620,2048,1896,0,1694,155,47,152,107,0,76,31,45,1572,1412,0,1031,381,160,252,7.0,2.5,29.6,10.2,331110.99609375,2308.44657408908
48825,11233,11233,36047037900,183760,0,Census Tract 379,New York,Kings County,1917,3072,1990,1934,0,1683,234,17,56,46,0,46,0,10,1082,1004,0,709,295,78,105,3.4,0.9,17.9,7.2,319852.2265625,2273.29256938566
48826,11233,11233,36047038100,239523,0,Census Tract 381,New York,Kings County,2547,4181,2772,2628,9,2205,333,81,144,120,0,99,21,24,1409,1167,0,687,480,242,347,8.3,3.1,16.7,17.2,416919.3359375,2738.65059033635
48827,11223,11223,36047038200,233431,0,Census Tract 382,New York,Kings County,1911,4795,2492,2018,0,1555,356,107,474,454,0,454,0,20,2303,1710,0,1561,149,593,720,15.0,5.3,4.2,25.7,405231.89453125,2458.91373610518
48828,11221,11221,36047038300,174539,0,Census Tract 383,New York,Kings County,2270,3572,2441,2312,0,2085,185,42,129,129,0,89,40,0,1131,1069,0,742,327,62,104,2.9,1.8,0.0,5.5,303835.94921875,2265.2013625375503
48828,11233,11233,36047038300,174539,0,Census Tract 383,New York,Kings County,2270,3572,2441,2312,0,2085,185,42,129,129,0,89,40,0,1131,1069,0,742,327,62,104,2.9,1.8,0.0,5.5,303835.94921875,2265.2013625375503
48829,11221,11221,36047038500,174443,0,Census Tract 385,New York,Kings County,1918,3288,2097,1942,0,1767,151,24,155,130,0,96,34,25,1191,1004,0,898,106,187,236,7.2,1.2,16.1,15.7,303696.83984375,2265.70747227242
48830,11223,11223,36047038600,251188,0,Census Tract 386,New York,Kings County,1457,2798,1627,1481,22,1393,42,24,146,146,0,146,0,0,1171,1078,0,1011,67,93,117,4.2,1.6,0.0,7.9,436067.75390625,2925.50159148867
48831,11221,11221,36047038700,188275,0,Census Tract 387,New York,Kings County,1776,3110,2114,1891,0,1685,91,115,223,223,0,190,33,0,996,805,0,502,303,191,306,9.8,6.1,0.0,19.2,327809.84375,2292.6228325612196
48832,11223,11223,36047038800,197933,0,Census Tract 388,New York,Kings County,1822,2998,1910,1852,0,1785,37,30,58,58,0,58,0,0,1088,896,2,834,60,192,222,7.4,1.6,0.0,17.6,343623.4375,2389.13976492202
48833,11206,11206,36047038900,162930,0,Census Tract 389,New York,Kings County,1715,2486,1917,1795,0,1566,149,80,122,115,0,115,0,7,569,428,0,327,101,141,228,9.2,4.5,5.7,24.8,283752.8984375,2727.975783075
48833,11221,11221,36047038900,162930,0,Census Tract 389,New York,Kings County,1715,2486,1917,1795,0,1566,149,80,122,115,0,115,0,7,569,428,0,327,101,141,228,9.2,4.5,5.7,24.8,283752.8984375,2727.975783075
48834,11223,11223,36047039000,173841,0,Census Tract 390,New York,Kings County,836,1649,920,871,5,774,57,35,49,44,4,40,0,5,729,571,0,540,31,158,198,12.0,4.0,10.2,21.7,301797.7265625,2678.35753673923
48835,11206,11206,36047039100,166173,0,Census Tract 391,New York,Kings County,1415,2318,1686,1415,0,1233,182,0,271,251,0,251,0,20,632,452,0,378,74,180,200,8.6,0.0,7.4,28.5,289407.15234375,2511.88250851739
48835,11221,11221,36047039100,166173,0,Census Tract 391,New York,Kings County,1415,2318,1686,1415,0,1233,182,0,271,251,0,251,0,20,632,452,0,378,74,180,200,8.6,0.0,7.4,28.5,289407.15234375,2511.88250851739
48836,11223,11223,36047039200,174602,0,Census Tract 392,New York,Kings County,1364,2328,1455,1393,0,1334,30,29,62,62,0,62,0,0,873,792,0,784,8,81,110,4.7,2.1,0.0,9.3,303146.0,2247.5743981108103
48837,11221,11221,36047039300,189603,0,Census Tract 393,New York,Kings County,1988,3039,2251,2006,20,1810,158,18,245,234,0,187,47,11,788,588,19,345,224,200,229,7.5,0.9,4.5,25.4,330167.859375,2695.8709693025103
48838,11223,11223,36047039400,192099,0,Census Tract 394,New York,Kings County,745,1611,803,754,0,721,24,9,49,49,0,49,0,0,808,549,0,545,4,259,268,16.6,1.2,0.0,32.1,333551.9609375,2806.7779946327
48839,11221,11221,36047039500,159720,0,Census Tract 395,New York,Kings County,1858,3112,2264,1914,0,1674,184,56,350,350,0,271,79,0,848,560,0,424,136,288,344,11.1,2.9,0.0,34.0,278110.57421875,2342.71411992349
48840,11223,11223,36047039600,163301,0,Census Tract 396,New York,Kings County,767,1455,792,772,0,724,43,5,20,20,0,20,0,0,663,596,0,570,26,67,72,4.9,0.6,0.0,10.1,283541.38671875,2237.81844262224
48841,11221,11221,36047039700,159158,0,Census Tract 397,New York,Kings County,1456,2698,1724,1606,85,1185,186,150,118,76,0,67,9,42,974,641,0,527,114,333,525,19.5,9.3,35.6,34.2,277102.0625,2637.80000727667
48842,11223,11223,36047039800,202902,0,Census Tract 398,New York,Kings County,1160,2173,1347,1171,0,1118,42,11,176,176,0,168,8,0,826,629,0,603,26,197,208,9.6,0.9,0.0,23.8,352275.02734375,2834.61425240326
48843,11221,11221,36047039900,151236,0,Census Tract 399,New York,Kings County,1709,3191,2034,1785,0,1471,238,76,249,201,0,159,42,48,1157,990,0,782,208,167,291,9.1,4.3,19.3,14.4,263316.11328125,2569.0867498458897
48844,11223,11223,36047040000,192000,0,Census Tract 400,New York,Kings County,1463,2640,1709,1585,10,1453,0,122,124,124,0,124,0,0,931,702,20,648,34,229,351,13.3,7.7,0.0,24.6,333372.765625,2663.7289926747303
48845,11207,11207,36047040100,159606,0,Census Tract 401,New York,Kings County,1429,2443,1622,1562,0,1216,213,133,60,60,0,60,0,0,821,721,0,640,81,100,233,9.5,8.5,0.0,12.2,277859.59765625,2109.79103441097
48846,11223,11223,36047040200,197509,0,Census Tract 402,New York,Kings County,1213,2363,1371,1258,11,1134,68,45,113,106,0,106,0,7,992,794,6,752,36,198,250,10.6,3.6,6.2,20.0,342918.9765625,2353.1843619417
48847,11207,11207,36047040300,210275,0,Census Tract 403,New York,Kings County,1620,3071,1816,1682,0,1497,123,62,134,87,0,80,7,47,1255,1023,0,818,205,232,341,11.1,3.7,35.1,18.5,366045.52734375,2744.15800159371
48848,11214,11214,36047040400,153660,0,Census Tract 404,New York,Kings County,1118,2017,1254,1153,0,1060,58,35,101,90,0,81,9,11,763,615,0,568,47,148,194,9.6,3.0,10.9,19.4,266836.359375,3197.3760339642304
48848,11223,11223,36047040400,153660,0,Census Tract 404,New York,Kings County,1118,2017,1254,1153,0,1060,58,35,101,90,0,81,9,11,763,615,0,568,47,148,194,9.6,3.0,10.9,19.4,266836.359375,3197.3760339642304
48849,11207,11207,36047040500,138996,0,Census Tract 405,New York,Kings County,888,1349,934,909,24,750,114,21,25,25,0,15,10,0,415,321,21,270,30,94,115,8.5,2.3,0.0,22.7,241947.24609375,2025.50260721672
48850,11223,11223,36047040600,147049,0,Census Tract 406,New York,Kings County,1767,3050,1870,1767,0,1698,69,0,103,103,0,88,15,0,1180,1041,0,1034,7,139,139,4.6,0.0,0.0,11.8,255343.93359375,2230.83519056743
48851,11207,11207,36047040700,504834,0,Census Tract 407,New York,Kings County,0,0,0,0,0,0,0,0,0,0,0,0,0,0,0,0,0,0,0,0,0,,,,,878804.05859375,4302.041885862121
48852,11223,11223,36047040800,152930,0,Census Tract 408,New York,Kings County,1637,2794,1857,1657,0,1488,149,20,200,200,0,153,47,0,937,852,9,783,60,85,105,3.8,1.2,0.0,9.1,265562.30078125,2263.52142441785
48853,11207,11207,36047040900,172310,0,Census Tract 409,New York,Kings County,1829,2781,2022,1901,0,1693,136,72,121,121,0,121,0,0,759,679,15,494,170,80,152,5.5,3.8,0.0,10.5,300013.36328125,2162.4413538481303
48853,11237,11237,36047040900,172310,0,Census Tract 409,New York,Kings County,1829,2781,2022,1901,0,1693,136,72,121,121,0,121,0,0,759,679,15,494,170,80,152,5.5,3.8,0.0,10.5,300013.36328125,2162.4413538481303
48854,11223,11223,36047041000,142871,0,Census Tract 410,New York,Kings County,690,1563,737,690,0,659,31,0,47,42,0,42,0,5,826,680,0,641,39,146,151,9.7,0.0,10.6,17.7,248092.54296875,2407.16787075196
48855,11207,11207,36047041100,134881,0,Census Tract 411,New York,Kings County,1269,2570,1582,1431,27,1152,90,162,151,141,13,128,0,10,988,763,27,560,176,225,397,15.4,11.3,6.6,22.8,234824.0859375,2000.3307152655398
48856,11223,11223,36047041200,165322,0,Census Tract 412,New York,Kings County,1660,2630,1762,1687,0,1651,9,27,75,75,0,75,0,0,868,680,0,673,7,188,215,8.2,1.6,0.0,21.7,287105.4140625,2197.14893127371
48857,11207,11207,36047041300,162166,0,Census Tract 413,New York,Kings County,1793,3025,1894,1793,0,1717,76,0,101,79,0,58,21,22,1131,857,0,762,95,274,296,9.8,0.0,21.8,24.2,282343.18359375,2125.59466753152
48857,11221,11221,36047041300,162166,0,Census Tract 413,New York,Kings County,1793,3025,1894,1793,0,1717,76,0,101,79,0,58,21,22,1131,857,0,762,95,274,296,9.8,0.0,21.8,24.2,282343.18359375,2125.59466753152
48858,11223,11223,36047041401,135123,0,Census Tract 414.01,New York,Kings County,592,1116,662,592,0,587,5,0,70,70,0,65,5,0,454,395,0,395,0,59,59,5.3,0.0,0.0,13.0,234643.07421875,2086.29872068765
48859,11223,11223,36047041402,154394,0,Census Tract 414.02,New York,Kings County,728,1360,809,750,0,716,12,22,59,59,0,59,0,0,551,454,0,419,35,97,119,8.8,2.9,0.0,17.6,268115.07421875,2284.92032737823
48860,11221,11221,36047041500,162692,0,Census Tract 415,New York,Kings County,1954,3110,2280,2053,0,1716,238,99,227,203,0,183,20,24,830,669,0,552,117,161,284,9.1,4.8,10.6,19.4,283277.765625,2142.43531767365
48861,11223,11223,36047041600,162563,0,Census Tract 416,New York,Kings County,731,1639,865,796,0,680,51,65,69,69,0,60,9,0,774,522,0,494,28,252,317,19.3,8.2,0.0,32.6,282296.9765625,2478.64015234935
48862,11221,11221,36047041700,141142,0,Census Tract 417,New York,Kings County,1227,2624,1439,1350,20,1050,157,123,89,89,0,89,0,0,1185,677,51,515,111,508,631,24.0,9.1,0.0,42.9,245768.9921875,2021.06715599835
48863,11223,11223,36047041800,164317,0,Census Tract 418,New York,Kings County,643,1752,812,673,0,621,22,30,139,139,0,133,6,0,940,687,0,639,48,253,283,16.2,4.5,0.0,26.9,285372.84375,2641.5911722483397
48864,11221,11221,36047041900,153013,0,Census Tract 419,New York,Kings County,1573,2878,1850,1665,11,1321,241,92,185,162,0,156,6,23,1028,874,29,649,196,154,269,9.3,5.5,12.4,15.0,266451.109375,2101.09826386323
48865,11223,11223,36047042000,168649,0,Census Tract 420,New York,Kings County,511,1195,595,555,0,488,23,44,40,40,0,40,0,0,600,469,0,396,73,131,175,14.6,7.9,0.0,21.8,292928.31640625,2793.70379452965
48865,11230,11230,36047042000,168649,0,Census Tract 420,New York,Kings County,511,1195,595,555,0,488,23,44,40,40,0,40,0,0,600,469,0,396,73,131,175,14.6,7.9,0.0,21.8,292928.31640625,2793.70379452965
48866,11221,11221,36047042100,153377,0,Census Tract 421,New York,Kings County,2099,3292,2350,2156,0,2007,92,57,194,184,0,155,29,10,942,707,0,533,174,235,302,9.2,2.6,5.2,24.9,267097.32421875,2113.07970268664
48867,11223,11223,36047042200,227280,0,Census Tract 422,New York,Kings County,1556,2635,1720,1565,0,1524,32,9,155,155,0,147,8,0,915,765,0,709,56,150,159,6.0,0.6,0.0,16.4,394736.29296875,2478.63552914667
48868,11206,11206,36047042300,182229,0,Census Tract 423,New York,Kings County,2195,3369,2582,2348,0,1914,281,153,234,234,0,221,13,0,787,713,0,625,88,74,227,6.7,6.5,0.0,9.4,317356.9140625,2241.6582984706
48868,11221,11221,36047042300,182229,0,Census Tract 423,New York,Kings County,2195,3369,2582,2348,0,1914,281,153,234,234,0,221,13,0,787,713,0,625,88,74,227,6.7,6.5,0.0,9.4,317356.9140625,2241.6582984706
48869,11223,11223,36047042400,161032,0,Census Tract 424,New York,Kings County,1759,2967,1916,1840,0,1571,188,81,76,76,0,76,0,0,1051,828,0,773,55,223,304,10.2,4.4,0.0,21.2,279674.8359375,2645.1824557046602
48870,11206,11206,36047042500,167840,0,Census Tract 425,New York,Kings County,1895,2462,2005,1969,0,1758,137,74,36,36,0,36,0,0,457,386,0,320,66,71,145,5.9,3.8,0.0,15.5,292321.50390625,2112.74814508197
48871,11223,11223,36047042600,170007,0,Census Tract 426,New York,Kings County,2012,3587,2127,2012,0,1955,57,0,115,106,0,100,6,9,1460,1297,0,1196,101,163,172,4.8,0.0,7.8,11.2,295254.14453125,2229.84736126807
48872,11237,11237,36047042700,148265,0,Census Tract 427,New York,Kings County,2741,4070,2990,2809,0,2510,231,68,181,181,0,181,0,0,1080,1012,0,776,236,68,136,3.3,2.4,0.0,6.3,258247.3515625,2103.9948799231897
48873,11214,11214,36047042800,164705,0,Census Tract 428,New York,Kings County,1610,3211,1878,1699,43,1494,73,89,179,179,0,148,31,0,1333,1077,47,972,58,256,345,10.7,5.2,0.0,19.2,286045.67578125,2678.5322993448103
48873,11223,11223,36047042800,164705,0,Census Tract 428,New York,Kings County,1610,3211,1878,1699,43,1494,73,89,179,179,0,148,31,0,1333,1077,47,972,58,256,345,10.7,5.2,0.0,19.2,286045.67578125,2678.5322993448103
48874,11237,11237,36047042900,168134,0,Census Tract 429,New York,Kings County,2740,4307,3054,2898,228,2455,57,158,156,124,0,100,24,32,1253,965,43,854,68,288,478,11.1,5.5,20.5,23.0,292840.171875,2166.48138481887
48875,11204,11204,36047043000,160029,0,Census Tract 430,New York,Kings County,1467,2736,1652,1489,0,1307,160,22,163,156,0,140,16,7,1084,867,0,688,179,217,246,9.0,1.5,4.3,20.0,277953.75390625,2525.4436472929897
48876,11237,11237,36047043100,168208,0,Census Tract 431,New York,Kings County,2594,3861,2854,2722,63,2379,152,128,132,109,0,109,0,23,1007,816,53,582,181,191,342,8.9,4.7,17.4,19.0,292949.29296875,2166.871295576
48877,11204,11204,36047043200,148819,0,Census Tract 432,New York,Kings County,1977,3522,2202,2016,0,1897,80,39,186,186,0,158,28,0,1320,1056,0,1006,50,264,303,8.6,1.9,0.0,20.0,258494.96484375,2207.5433569490697
48878,11221,11221,36047043300,168245,0,Census Tract 433,New York,Kings County,1509,3128,1814,1689,30,1257,222,180,125,114,0,95,19,11,1314,992,0,761,231,322,513,16.4,10.7,8.8,24.5,292993.59765625,2167.05628679419
48878,11237,11237,36047043300,168245,0,Census Tract 433,New York,Kings County,1509,3128,1814,1689,30,1257,222,180,125,114,0,95,19,11,1314,992,0,761,231,322,513,16.4,10.7,8.8,24.5,292993.59765625,2167.05628679419
48879,11204,11204,36047043400,139658,0,Census Tract 434,New York,Kings County,1441,2641,1666,1594,8,1323,110,153,72,72,0,62,10,0,975,801,9,730,62,174,327,12.4,9.6,0.0,17.8,242580.5859375,2210.40328772119
48880,11221,11221,36047043500,168158,0,Census Tract 435,New York,Kings County,2406,4006,2712,2551,0,2237,169,145,161,127,0,127,0,34,1294,1147,0,984,163,147,326,8.1,5.7,21.1,11.4,292825.71875,2166.08542043524
48880,11237,11237,36047043500,168158,0,Census Tract 435,New York,Kings County,2406,4006,2712,2551,0,2237,169,145,161,127,0,127,0,34,1294,1147,0,984,163,147,326,8.1,5.7,21.1,11.4,292825.71875,2166.08542043524
48881,11204,11204,36047043600,137521,0,Census Tract 436,New York,Kings County,2314,3752,2475,2350,9,2305,0,36,125,125,0,125,0,0,1277,937,20,876,41,340,376,10.0,1.5,0.0,26.6,238890.37890625,2341.2656471191
48882,11207,11207,36047043700,168127,0,Census Tract 437,New York,Kings County,2748,4648,3329,3144,0,2327,421,396,185,156,0,139,17,29,1319,914,0,790,124,405,830,17.9,12.6,15.7,30.7,292750.28515625,2166.1235016936103
48882,11221,11221,36047043700,168127,0,Census Tract 437,New York,Kings County,2748,4648,3329,3144,0,2327,421,396,185,156,0,139,17,29,1319,914,0,790,124,405,830,17.9,12.6,15.7,30.7,292750.28515625,2166.1235016936103
48882,11237,11237,36047043700,168127,0,Census Tract 437,New York,Kings County,2748,4648,3329,3144,0,2327,421,396,185,156,0,139,17,29,1319,914,0,790,124,405,830,17.9,12.6,15.7,30.7,292750.28515625,2166.1235016936103
48883,11204,11204,36047043800,156072,0,Census Tract 438,New York,Kings County,1095,2010,1203,1143,0,972,123,48,60,60,0,60,0,0,807,667,7,527,133,140,188,9.4,4.2,0.0,17.3,271088.9296875,2188.63499546236
48883,11230,11230,36047043800,156072,0,Census Tract 438,New York,Kings County,1095,2010,1203,1143,0,972,123,48,60,60,0,60,0,0,807,667,7,527,133,140,188,9.4,4.2,0.0,17.3,271088.9296875,2188.63499546236
48884,11237,11237,36047043900,200003,0,Census Tract 439,New York,Kings County,1686,3109,1956,1756,46,1265,375,70,200,200,0,200,0,0,1153,901,43,730,128,252,322,10.4,4.0,0.0,21.9,348303.609375,3282.3949131865197
48885,11204,11204,36047044000,201542,0,Census Tract 440,New York,Kings County,945,1996,1130,1015,0,818,127,70,115,115,0,79,36,0,866,799,0,703,96,67,137,6.9,6.9,0.0,7.7,350099.078125,2698.79589386963
48885,11230,11230,36047044000,201542,0,Census Tract 440,New York,Kings County,945,1996,1130,1015,0,818,127,70,115,115,0,79,36,0,866,799,0,703,96,67,137,6.9,6.9,0.0,7.7,350099.078125,2698.79589386963
48886,11237,11237,36047044100,142020,0,Census Tract 441,New York,Kings County,2618,4362,3222,2853,41,2284,293,235,369,350,0,281,69,19,1140,902,25,724,153,238,492,11.3,8.2,5.1,20.9,247354.234375,2218.5104260194603
48887,11230,11230,36047044200,182832,0,Census Tract 442,New York,Kings County,1029,1991,1095,1053,11,841,177,24,42,42,0,42,0,0,896,700,0,580,120,196,220,11.0,2.3,0.0,21.9,317590.80859375,2736.12396109281
48888,11237,11237,36047044300,167769,0,Census Tract 443,New York,Kings County,2707,4014,2931,2762,0,2562,145,55,169,169,0,155,14,0,1083,841,36,722,83,242,297,7.4,2.0,0.0,22.3,292216.82421875,2233.83230289839
48889,11230,11230,36047044400,174544,0,Census Tract 444,New York,Kings County,1052,2349,1281,1230,0,947,105,178,51,29,0,29,0,22,1068,710,0,678,32,358,558,23.8,14.5,43.1,33.5,303224.9921875,2421.34669037138
48890,11237,11237,36047044500,169739,0,Census Tract 445,New York,Kings County,2491,3863,2627,2528,0,2144,347,37,99,99,0,99,0,0,1236,1023,33,851,139,213,250,6.5,1.5,0.0,17.2,295662.08984375,2249.2269187018696
48891,11204,11204,36047044600,141398,0,Census Tract 446,New York,Kings County,923,1657,1046,993,0,806,117,70,53,53,0,40,13,0,611,567,0,558,9,44,114,6.9,7.0,0.0,7.2,245639.4140625,2592.4625887693696
48891,11230,11230,36047044600,141398,0,Census Tract 446,New York,Kings County,923,1657,1046,993,0,806,117,70,53,53,0,40,13,0,611,567,0,558,9,44,114,6.9,7.0,0.0,7.2,245639.4140625,2592.4625887693696
48892,11237,11237,36047044700,162809,0,Census Tract 447,New York,Kings County,1061,1570,1106,1073,14,973,74,12,33,22,0,22,0,11,464,411,14,379,18,53,76,4.8,1.1,33.3,11.4,283604.2734375,2222.5949898896397
48893,11204,11204,36047044800,226807,0,Census Tract 448,New York,Kings County,803,1506,899,833,0,753,50,30,66,66,0,66,0,0,607,450,8,408,34,157,187,12.4,3.6,0.0,25.9,394044.94921875,3203.48017056464
48893,11230,11230,36047044800,226807,0,Census Tract 448,New York,Kings County,803,1506,899,833,0,753,50,30,66,66,0,66,0,0,607,450,8,408,34,157,187,12.4,3.6,0.0,25.9,394044.94921875,3203.48017056464
48894,11211,11211,36047044900,2143293,175743,Census Tract 449,New York,Kings County,931,2182,1447,1265,0,920,11,334,182,99,0,99,0,83,735,522,10,439,73,213,630,28.9,26.4,45.6,29.0,3684174.421875,13257.292252191899
48894,11222,11222,36047044900,2143293,175743,Census Tract 449,New York,Kings County,931,2182,1447,1265,0,920,11,334,182,99,0,99,0,83,735,522,10,439,73,213,630,28.9,26.4,45.6,29.0,3684174.421875,13257.292252191899
48894,11237,11237,36047044900,2143293,175743,Census Tract 449,New York,Kings County,931,2182,1447,1265,0,920,11,334,182,99,0,99,0,83,735,522,10,439,73,213,630,28.9,26.4,45.6,29.0,3684174.421875,13257.292252191899
48895,11230,11230,36047045000,218440,0,Census Tract 450,New York,Kings County,176,360,197,197,0,148,28,21,0,0,0,0,0,0,163,159,0,142,17,4,25,6.9,10.7,,2.5,379549.828125,2501.64112441422
48896,11230,11230,36047045200,186316,0,Census Tract 452,New York,Kings County,977,1787,1073,1040,0,860,117,63,33,33,0,27,6,0,714,627,0,513,114,87,150,8.4,6.1,0.0,12.2,323718.234375,2884.80072461208
48897,11206,11206,36047045300,319530,0,Census Tract 453,New York,Kings County,1083,1427,1126,1101,0,1029,54,18,25,25,0,25,0,0,301,273,8,220,45,28,46,3.2,1.6,0.0,9.3,556603.72265625,3558.17923257808
48897,11237,11237,36047045300,319530,0,Census Tract 453,New York,Kings County,1083,1427,1126,1101,0,1029,54,18,25,25,0,25,0,0,301,273,8,220,45,28,46,3.2,1.6,0.0,9.3,556603.72265625,3558.17923257808
48898,11230,11230,36047045400,132312,0,Census Tract 454,New York,Kings County,735,1251,779,749,0,634,101,14,30,30,0,25,5,0,472,427,0,314,113,45,59,4.7,1.9,0.0,9.5,229877.1640625,2557.81413023546
48899,11230,11230,36047045600,153654,0,Census Tract 456,New York,Kings County,816,1604,941,839,0,762,54,23,102,102,0,47,55,0,663,564,0,404,160,99,122,7.6,2.7,0.0,14.9,267015.9140625,2766.96381280242
48900,11230,11230,36047045800,179391,0,Census Tract 458,New York,Kings County,535,1198,592,542,0,463,72,7,50,50,0,32,18,0,606,528,0,392,136,78,85,7.1,1.3,0.0,12.9,311735.56640625,2884.44448644151
48901,11230,11230,36047046000,196068,0,Census Tract 460,New York,Kings County,1273,2758,1400,1312,0,1240,33,39,88,88,0,88,0,0,1358,1072,0,1016,56,286,325,11.8,3.0,0.0,21.1,340779.484375,3735.02441737714
48902,11230,11230,36047046201,128315,0,Census Tract 462.01,New York,Kings County,807,1886,1020,944,0,724,83,137,76,76,0,42,34,0,866,526,0,425,101,340,477,25.3,14.5,0.0,39.3,222993.96484375,2002.4731207103
48903,11204,11204,36047046202,172849,0,Census Tract 462.02,New York,Kings County,692,1430,801,766,0,610,82,74,35,21,0,21,0,14,629,558,0,475,83,71,159,11.1,9.7,40.0,11.3,300358.6484375,2955.5559948056703
48903,11230,11230,36047046202,172849,0,Census Tract 462.02,New York,Kings County,692,1430,801,766,0,610,82,74,35,21,0,21,0,14,629,558,0,475,83,71,159,11.1,9.7,40.0,11.3,300358.6484375,2955.5559948056703
48904,11204,11204,36047046400,164012,0,Census Tract 464,New York,Kings County,755,1528,877,872,12,582,161,117,5,5,0,5,0,0,651,488,0,369,119,163,280,18.3,13.4,0.0,25.0,285000.62109375,2504.42581721297
48905,11204,11204,36047046800,295918,0,Census Tract 468,New York,Kings County,526,1163,615,585,0,366,160,59,30,22,0,16,6,8,548,450,0,329,121,98,165,14.2,10.1,26.7,17.9,514169.296875,3533.6879635903706
48906,11204,11204,36047047000,181816,0,Census Tract 470,New York,Kings County,778,1609,905,874,16,509,253,96,31,31,0,31,0,0,704,515,0,380,135,189,285,17.7,11.0,0.0,26.8,315948.51953125,2935.0238070287896
48907,11204,11204,36047047200,172804,0,Census Tract 472,New York,Kings County,504,1477,758,712,14,325,165,208,46,40,0,23,17,6,719,519,0,300,219,200,414,28.0,29.2,13.0,27.8,300300.00390625,2719.6446968678
48908,11204,11204,36047047400,175872,0,Census Tract 474,New York,Kings County,660,1587,920,866,0,484,176,206,54,38,0,34,4,16,667,446,0,303,143,221,443,27.9,23.8,29.6,33.1,305652.4765625,2579.8978358328895
48909,11204,11204,36047047600,207177,0,Census Tract 476,New York,Kings County,929,2368,1340,1171,18,520,391,242,169,111,0,54,57,58,1028,556,8,331,217,472,772,32.6,20.7,34.3,45.9,360076.53125,3028.4543099318703
48909,11230,11230,36047047600,207177,0,Census Tract 476,New York,Kings County,929,2368,1340,1171,18,520,391,242,169,111,0,54,57,58,1028,556,8,331,217,472,772,32.6,20.7,34.3,45.9,360076.53125,3028.4543099318703
48910,11211,11211,36047047700,217805,0,Census Tract 477,New York,Kings County,2806,3375,2900,2820,0,2602,204,14,80,80,0,80,0,0,475,426,0,374,52,49,63,1.9,0.5,0.0,10.3,379537.6796875,3513.98948247884
48910,11222,11222,36047047700,217805,0,Census Tract 477,New York,Kings County,2806,3375,2900,2820,0,2602,204,14,80,80,0,80,0,0,475,426,0,374,52,49,63,1.9,0.5,0.0,10.3,379537.6796875,3513.98948247884
48911,11204,11204,36047047800,221220,0,Census Tract 478,New York,Kings County,1463,2998,1763,1719,0,762,701,256,44,44,0,36,8,0,1235,828,0,549,279,407,663,22.1,14.9,0.0,33.0,384514.5234375,2792.7116801211896
48911,11218,11218,36047047800,221220,0,Census Tract 478,New York,Kings County,1463,2998,1763,1719,0,762,701,256,44,44,0,36,8,0,1235,828,0,549,279,407,663,22.1,14.9,0.0,33.0,384514.5234375,2792.7116801211896
48912,11218,11218,36047048000,153160,0,Census Tract 480,New York,Kings County,1454,2678,1620,1499,0,1318,136,45,121,69,0,69,0,52,1058,880,0,734,146,178,275,10.3,3.0,43.0,16.8,266190.921875,2184.48979910882
48912,11230,11230,36047048000,153160,0,Census Tract 480,New York,Kings County,1454,2678,1620,1499,0,1318,136,45,121,69,0,69,0,52,1058,880,0,734,146,178,275,10.3,3.0,43.0,16.8,266190.921875,2184.48979910882
48913,11211,11211,36047048100,151301,0,Census Tract 481,New York,Kings County,2029,2790,2166,2029,0,1969,60,0,137,137,0,59,78,0,624,425,0,328,97,199,199,7.1,0.0,0.0,31.9,263615.39453125,2138.47009736047
48914,11218,11218,36047048200,196676,0,Census Tract 482,New York,Kings County,2205,4210,2414,2256,0,1885,320,51,158,141,0,141,0,17,1796,1526,0,1214,312,270,338,8.0,2.3,10.8,15.0,341854.00390625,2695.23783252751
48914,11230,11230,36047048200,196676,0,Census Tract 482,New York,Kings County,2205,4210,2414,2256,0,1885,320,51,158,141,0,141,0,17,1796,1526,0,1214,312,270,338,8.0,2.3,10.8,15.0,341854.00390625,2695.23783252751
48915,11218,11218,36047048400,209195,0,Census Tract 484,New York,Kings County,2008,3772,2216,2151,0,1839,169,143,65,65,0,65,0,0,1556,1276,10,1055,211,280,423,11.2,6.6,0.0,18.0,363622.8046875,2532.4420364464
48916,11206,11206,36047048500,580983,0,Census Tract 485,New York,Kings County,1931,2468,2036,1937,0,1775,156,6,99,99,0,99,0,0,432,398,0,321,77,34,40,1.6,0.3,0.0,7.9,1012079.984375,4684.31242710555
48916,11211,11211,36047048500,580983,0,Census Tract 485,New York,Kings County,1931,2468,2036,1937,0,1775,156,6,99,99,0,99,0,0,432,398,0,321,77,34,40,1.6,0.3,0.0,7.9,1012079.984375,4684.31242710555
48917,11218,11218,36047048600,175438,0,Census Tract 486,New York,Kings County,1228,2383,1390,1320,41,1058,129,92,70,70,0,70,0,0,993,788,26,657,105,205,297,12.5,7.0,0.0,20.6,304985.05859375,2879.1989972481297
48918,11218,11218,36047048800,143330,0,Census Tract 488,New York,Kings County,1449,3038,1751,1609,0,1186,263,160,142,115,0,115,0,27,1287,1062,0,691,371,225,412,13.6,9.9,19.0,17.5,249183.94140625,2505.0854794081697
48919,11206,11206,36047048900,91581,0,Census Tract 489,New York,Kings County,793,2755,1287,983,0,597,196,190,304,295,0,284,11,9,1468,789,0,520,269,679,878,31.9,19.3,3.0,46.3,159511.47265625,1633.94894306008
48920,11218,11218,36047049000,191799,0,Census Tract 490,New York,Kings County,2656,4039,2995,2677,0,2498,158,21,318,318,0,318,0,0,1044,876,0,703,173,168,189,4.7,0.8,0.0,16.1,333424.8984375,2691.7433439639603
48921,11206,11206,36047049100,213164,0,Census Tract 491,New York,Kings County,3005,5620,3332,3067,50,2726,229,62,265,265,0,138,127,0,2288,1996,21,1707,268,292,354,6.3,2.0,0.0,12.8,371289.7109375,2977.2172063298303
48922,11218,11218,36047049200,166635,0,Census Tract 492,New York,Kings County,1219,2313,1346,1281,26,1107,86,62,65,65,0,41,24,0,967,779,0,679,100,188,250,10.8,4.8,0.0,19.4,289702.28515625,3273.43602892312
48923,11206,11206,36047049300,228008,0,Census Tract 493,New York,Kings County,3107,6394,3611,3148,0,2787,320,41,463,463,0,460,3,0,2783,2403,0,2168,235,380,421,6.6,1.3,0.0,13.7,397195.05859375,2866.17276583023
48924,11218,11218,36047049400,182730,0,Census Tract 494,New York,Kings County,2386,4163,2592,2386,0,2136,250,0,206,206,0,189,17,0,1571,1167,0,1038,129,404,404,9.7,0.0,0.0,25.7,317702.6015625,2290.23189920972
48925,11206,11206,36047049500,129103,0,Census Tract 495,New York,Kings County,1810,2401,1953,1824,0,1737,73,14,129,121,0,121,0,8,448,415,0,406,9,33,55,2.3,0.8,6.2,7.4,224930.1328125,1905.7714162027398
48925,11211,11211,36047049500,129103,0,Census Tract 495,New York,Kings County,1810,2401,1953,1824,0,1737,73,14,129,121,0,121,0,8,448,415,0,406,9,33,55,2.3,0.8,6.2,7.4,224930.1328125,1905.7714162027398
48926,11218,11218,36047049600,202972,0,Census Tract 496,New York,Kings County,1964,3283,2110,2000,0,1867,97,36,110,76,0,76,0,34,1173,1036,0,955,81,137,207,6.3,1.8,30.9,11.7,352903.18359375,2906.0978609999997
48927,11211,11211,36047049700,164636,0,Census Tract 497,New York,Kings County,2176,2677,2253,2213,0,2078,98,37,40,40,0,40,0,0,424,281,0,241,40,143,180,6.7,1.7,0.0,33.7,286870.328125,2386.0841565661603
48928,11218,11218,36047049800,204347,0,Census Tract 498,New York,Kings County,2298,3398,2495,2344,26,2219,53,46,151,151,0,142,9,0,903,760,15,740,5,143,189,5.6,2.0,0.0,15.8,355316.6640625,2876.2159541584497
48929,11222,11222,36047049900,141699,0,Census Tract 499,New York,Kings County,1194,1602,1390,1294,0,1135,59,100,96,76,0,76,0,20,212,147,0,142,5,65,185,11.5,7.7,20.8,30.7,246937.6015625,2020.6544133087802
48930,11218,11218,36047050000,202227,0,Census Tract 500,New York,Kings County,1889,2854,2009,1920,0,1837,52,31,89,89,0,80,9,0,845,746,0,729,17,99,130,4.6,1.6,0.0,11.7,351661.33984375,2638.42685079598
48931,11211,11211,36047050100,172687,0,Census Tract 501,New York,Kings County,1971,2868,2123,1971,0,1854,117,0,152,152,0,152,0,0,745,550,0,531,19,195,195,6.8,0.0,0.0,26.2,300894.3359375,2510.30817040126
48932,11218,11218,36047050202,135737,0,Census Tract 502.02,New York,Kings County,1218,1871,1240,1218,0,1188,30,0,22,22,0,22,0,0,631,515,0,497,18,116,116,6.2,0.0,0.0,18.4,236072.04296875,2159.84341268929
48933,11206,11206,36047050300,125308,0,Census Tract 503,New York,Kings County,1681,2377,1908,1788,0,1646,35,107,120,99,0,84,15,21,469,401,0,355,46,68,196,8.2,6.0,17.5,14.5,218315.61328125,2024.97863606322
48933,11211,11211,36047050300,125308,0,Census Tract 503,New York,Kings County,1681,2377,1908,1788,0,1646,35,107,120,99,0,84,15,21,469,401,0,355,46,68,196,8.2,6.0,17.5,14.5,218315.61328125,2024.97863606322
48934,11218,11218,36047050400,229309,0,Census Tract 504,New York,Kings County,2371,3622,2464,2371,20,2267,84,0,93,93,0,93,0,0,1158,1024,0,875,149,134,134,3.7,0.0,0.0,11.6,398760.30078125,2933.7734931024297
48935,11206,11206,36047050500,169412,0,Census Tract 505,New York,Kings County,1887,3401,2128,1915,0,1795,92,28,213,160,0,160,0,53,1273,797,0,680,117,476,557,16.4,1.5,24.9,37.4,295116.1953125,2431.86915682133
48936,11218,11218,36047050600,164685,0,Census Tract 506,New York,Kings County,2393,4235,2953,2750,15,2239,139,357,203,203,0,177,26,0,1282,1045,13,974,58,237,594,14.0,13.0,0.0,18.5,286381.84765625,2689.66259898788
48936,11226,11226,36047050600,164685,0,Census Tract 506,New York,Kings County,2393,4235,2953,2750,15,2239,139,357,203,203,0,177,26,0,1282,1045,13,974,58,237,594,14.0,13.0,0.0,18.5,286381.84765625,2689.66259898788
48937,11206,11206,36047050700,174429,0,Census Tract 507,New York,Kings County,502,1379,800,720,0,357,145,218,80,75,0,75,0,5,579,344,0,287,57,235,458,33.2,30.3,6.3,40.6,303801.32421875,2468.59540231903
48938,11226,11226,36047050801,78240,0,Census Tract 508.01,New York,Kings County,1765,3308,2132,1939,0,1433,332,174,193,172,0,110,62,21,1176,1011,0,730,281,165,360,10.9,9.0,10.9,14.0,136063.71875,1508.65476783172
48939,11226,11226,36047050803,56086,0,Census Tract 508.03,New York,Kings County,1217,1919,1384,1310,0,1126,91,93,74,54,0,54,0,20,535,452,0,411,41,83,196,10.2,7.1,27.0,15.5,97544.546875,1311.69255907446
48940,11226,11226,36047050804,103103,0,Census Tract 508.04,New York,Kings County,2952,5007,3440,3266,0,2774,178,314,174,147,0,147,0,27,1567,1308,0,1185,123,259,600,12.0,9.6,15.5,16.5,179312.171875,1727.23482007996
48941,11206,11206,36047050900,141788,0,Census Tract 509,New York,Kings County,526,2037,1076,1050,7,324,195,524,26,20,0,16,4,6,961,560,7,228,325,401,931,45.7,49.9,23.1,41.7,246962.78125,2019.04750215719
48942,11226,11226,36047051001,76942,0,Census Tract 510.01,New York,Kings County,1891,3461,2227,2012,0,1663,228,121,215,177,0,177,0,38,1234,1036,0,833,203,198,357,10.3,6.0,17.7,16.0,133786.3984375,1468.14383456201
48943,11226,11226,36047051002,107067,0,Census Tract 510.02,New York,Kings County,2230,3643,2541,2440,0,1935,295,210,101,90,0,76,14,11,1102,812,0,656,156,290,511,14.0,8.6,10.9,26.3,186183.07421875,1801.6482731108802
48944,11206,11206,36047051100,159004,0,Census Tract 511,New York,Kings County,2170,3814,2481,2248,0,1953,217,78,233,233,0,152,81,0,1333,870,0,626,244,463,541,14.2,3.5,0.0,34.7,276983.453125,2129.11834559038
48945,11226,11226,36047051200,139992,0,Census Tract 512,New York,Kings County,2973,4612,3382,3112,0,2567,406,139,270,270,0,237,33,0,1230,1061,0,877,184,169,308,6.7,4.5,0.0,13.7,243422.671875,2223.17929522141
48946,11206,11206,36047051300,258100,0,Census Tract 513,New York,Kings County,3477,4780,3762,3572,0,3312,165,95,190,179,0,179,0,11,1018,701,0,587,114,317,423,8.8,2.7,5.8,31.1,449664.41015625,2864.15139767051
48946,11211,11211,36047051300,258100,0,Census Tract 513,New York,Kings County,3477,4780,3762,3572,0,3312,165,95,190,179,0,179,0,11,1018,701,0,587,114,317,423,8.8,2.7,5.8,31.1,449664.41015625,2864.15139767051
48947,11226,11226,36047051400,181082,0,Census Tract 514,New York,Kings County,3346,5663,3953,3651,0,3058,288,305,302,302,0,228,74,0,1710,1289,0,1203,86,421,726,12.8,8.4,0.0,24.6,314838.33203125,2529.52232391697
48948,11211,11211,36047051500,186924,0,Census Tract 515,New York,Kings County,1664,1917,1714,1690,0,1635,29,26,24,24,0,24,0,0,203,159,0,159,0,44,70,3.7,1.5,0.0,21.7,325729.359375,2764.7058537542894
48948,11222,11222,36047051500,186924,0,Census Tract 515,New York,Kings County,1664,1917,1714,1690,0,1635,29,26,24,24,0,24,0,0,203,159,0,159,0,44,70,3.7,1.5,0.0,21.7,325729.359375,2764.7058537542894
48949,11210,11210,36047051601,115923,0,Census Tract 516.01,New York,Kings County,2422,4431,2717,2532,0,2134,288,110,185,185,0,155,30,0,1714,1418,0,1239,179,296,406,9.2,4.3,0.0,17.3,201524.265625,1824.9208212086498
48949,11226,11226,36047051601,115923,0,Census Tract 516.01,New York,Kings County,2422,4431,2717,2532,0,2134,288,110,185,185,0,155,30,0,1714,1418,0,1239,179,296,406,9.2,4.3,0.0,17.3,201524.265625,1824.9208212086498
48950,11226,11226,36047051602,91134,0,Census Tract 516.02,New York,Kings County,1820,3201,2114,1953,0,1622,198,133,161,139,0,36,103,22,1087,977,0,842,135,110,265,8.3,6.8,13.7,10.1,158441.640625,1853.56453614575
48951,11211,11211,36047051700,187367,0,Census Tract 517,New York,Kings County,1805,2285,1869,1835,0,1728,77,30,34,34,0,34,0,0,416,350,0,327,23,66,96,4.2,1.6,0.0,15.9,326521.5390625,2504.08805838245
48951,11222,11222,36047051700,187367,0,Census Tract 517,New York,Kings County,1805,2285,1869,1835,0,1728,77,30,34,34,0,34,0,0,416,350,0,327,23,66,96,4.2,1.6,0.0,15.9,326521.5390625,2504.08805838245
48952,11226,11226,36047051800,201332,0,Census Tract 518,New York,Kings County,1694,2730,1811,1726,0,1512,182,32,85,85,0,69,16,0,919,701,0,539,162,218,250,9.2,1.9,0.0,23.7,349992.34375,2529.46832486245
48953,11211,11211,36047051900,274935,0,Census Tract 519,New York,Kings County,3778,4820,4019,3850,0,3664,114,72,169,169,0,169,0,0,801,520,0,404,116,281,353,7.3,1.9,0.0,35.1,479058.890625,3015.08136635409
48954,11218,11218,36047052000,190572,0,Census Tract 520,New York,Kings County,1959,3253,2230,2086,0,1913,46,127,144,112,0,109,3,32,1023,757,0,747,10,266,425,13.1,6.1,22.2,26.0,331283.828125,2800.0732252153603
48954,11226,11226,36047052000,190572,0,Census Tract 520,New York,Kings County,1959,3253,2230,2086,0,1913,46,127,144,112,0,109,3,32,1023,757,0,747,10,266,425,13.1,6.1,22.2,26.0,331283.828125,2800.0732252153603
48954,11230,11230,36047052000,190572,0,Census Tract 520,New York,Kings County,1959,3253,2230,2086,0,1913,46,127,144,112,0,109,3,32,1023,757,0,747,10,266,425,13.1,6.1,22.2,26.0,331283.828125,2800.0732252153603
48955,11211,11211,36047052300,144959,0,Census Tract 523,New York,Kings County,2890,4387,3102,2974,28,2440,422,84,128,128,0,73,55,0,1285,978,28,616,334,307,391,8.9,2.8,0.0,23.9,252549.04296875,2073.98513936429
48956,11211,11211,36047052500,124145,0,Census Tract 525,New York,Kings County,1018,2478,1363,1295,32,889,97,277,68,68,0,27,41,0,1115,592,60,400,132,523,800,32.3,21.4,0.0,46.9,216262.44921875,2049.08331618871
48957,11218,11218,36047052600,169330,0,Census Tract 526,New York,Kings County,2451,3722,2749,2513,0,2162,289,62,236,212,0,137,75,24,973,819,7,691,121,154,240,6.4,2.5,10.2,15.8,294347.8125,2708.80973942474
48957,11230,11230,36047052600,169330,0,Census Tract 526,New York,Kings County,2451,3722,2749,2513,0,2162,289,62,236,212,0,137,75,24,973,819,7,691,121,154,240,6.4,2.5,10.2,15.8,294347.8125,2708.80973942474
48958,11211,11211,36047052700,190002,0,Census Tract 527,New York,Kings County,3017,5422,3545,3168,0,2593,424,151,377,377,0,334,43,0,1877,1647,0,1114,533,230,381,7.0,4.8,0.0,12.3,330991.41796875,2590.9517552543302
48959,11230,11230,36047052800,175595,0,Census Tract 528,New York,Kings County,784,1502,874,857,0,689,95,73,17,17,0,17,0,0,628,532,0,466,66,96,169,11.3,8.5,0.0,15.3,305188.6015625,2926.2051072383197
48960,11206,11206,36047052900,174907,0,Census Tract 529,New York,Kings County,767,2171,1173,1155,18,373,376,388,18,0,0,0,0,18,998,524,18,213,293,474,880,40.5,33.6,100.0,47.5,304678.50390625,2459.80997207972
48960,11211,11211,36047052900,174907,0,Census Tract 529,New York,Kings County,767,2171,1173,1155,18,373,376,388,18,0,0,0,0,18,998,524,18,213,293,474,880,40.5,33.6,100.0,47.5,304678.50390625,2459.80997207972
48961,11230,11230,36047053000,173246,0,Census Tract 530,New York,Kings County,1457,2866,1718,1583,54,1266,137,126,135,120,0,106,14,15,1148,904,39,793,72,244,385,13.4,8.0,11.1,21.3,301077.47265625,2266.56023602439
48962,11206,11206,36047053100,161778,0,Census Tract 531,New York,Kings County,1298,4151,2428,2411,0,755,543,1113,17,6,0,0,6,11,1723,847,0,374,473,876,2000,48.2,46.2,64.7,50.8,281759.125,2239.3123676642103
48963,11230,11230,36047053200,174306,0,Census Tract 532,New York,Kings County,1050,2115,1304,1136,10,927,113,86,168,168,0,168,0,0,811,680,5,606,69,131,217,10.3,7.6,0.0,16.2,302902.75390625,2767.0824127592796
48964,11211,11211,36047053300,193137,0,Census Tract 533,New York,Kings County,803,3732,1800,1751,0,350,453,948,49,36,0,22,14,13,1932,758,0,266,492,1174,2135,57.2,54.1,26.5,60.8,336404.4453125,2428.0141811909602
48965,11230,11230,36047053400,173382,0,Census Tract 534,New York,Kings County,1428,2887,1683,1531,0,1228,200,103,152,35,0,35,0,117,1204,1096,0,874,222,108,328,11.4,6.7,77.0,9.0,301269.23828125,2267.21748695399
48966,11211,11211,36047053500,130364,0,Census Tract 535,New York,Kings County,474,2125,1166,1115,0,218,256,641,51,51,0,10,41,0,959,304,0,140,164,655,1296,61.0,57.5,0.0,68.3,227084.80859375,2096.4209753513396
48967,11211,11211,36047053700,167465,0,Census Tract 537,New York,Kings County,551,1733,957,913,0,149,402,362,44,38,0,8,30,6,776,539,0,154,385,237,605,34.9,39.6,13.6,30.5,291656.8671875,2282.5656702279002
48968,11230,11230,36047053800,164451,0,Census Tract 538,New York,Kings County,1946,3551,2171,2099,0,1790,156,153,72,72,0,54,18,0,1380,998,0,901,97,382,535,15.1,7.3,0.0,27.7,285709.9765625,2331.86052119127
48969,11211,11211,36047053900,101377,0,Census Tract 539,New York,Kings County,544,1630,864,834,0,415,129,290,30,24,0,13,11,6,766,334,0,161,173,432,728,44.7,34.8,20.0,56.4,176572.03125,1752.94127391328
48970,11230,11230,36047054200,189169,0,Census Tract 542,New York,Kings County,1638,3315,1901,1776,0,1508,130,138,125,98,0,88,10,27,1414,963,0,872,91,451,616,18.6,7.8,21.6,31.9,328603.0390625,2396.8046401695397
48971,11205,11205,36047054300,1053488,376699,Census Tract 543,New York,Kings County,304,353,339,304,0,277,27,0,35,35,0,35,0,0,14,14,0,14,0,0,0,0.0,0.0,0.0,0.0,1825000.87890625,16106.6280558725
48971,11211,11211,36047054300,1053488,376699,Census Tract 543,New York,Kings County,304,353,339,304,0,277,27,0,35,35,0,35,0,0,14,14,0,14,0,0,0,0.0,0.0,0.0,0.0,1825000.87890625,16106.6280558725
48972,11230,11230,36047054400,190006,0,Census Tract 544,New York,Kings County,1622,3094,1751,1641,0,1475,147,19,110,98,0,89,9,12,1343,1157,0,957,200,186,217,7.0,1.2,10.9,13.8,330062.4140625,2399.8638773527696
48973,11211,11211,36047054500,167760,0,Census Tract 545,New York,Kings County,1429,5128,2287,2152,0,1143,286,723,135,111,0,109,2,24,2841,1278,0,1001,277,1563,2310,45.0,33.6,17.8,55.0,292215.4609375,2137.1353380966
48974,11210,11210,36047054600,180667,0,Census Tract 546,New York,Kings County,1803,3593,1987,1843,10,1743,50,40,144,144,0,137,7,0,1606,1299,24,1149,126,307,347,9.7,2.2,0.0,19.1,313838.66015625,2673.02759396162
48974,11229,11229,36047054600,180667,0,Census Tract 546,New York,Kings County,1803,3593,1987,1843,10,1743,50,40,144,144,0,137,7,0,1606,1299,24,1149,126,307,347,9.7,2.2,0.0,19.1,313838.66015625,2673.02759396162
48974,11230,11230,36047054600,180667,0,Census Tract 546,New York,Kings County,1803,3593,1987,1843,10,1743,50,40,144,144,0,137,7,0,1606,1299,24,1149,126,307,347,9.7,2.2,0.0,19.1,313838.66015625,2673.02759396162
48975,11211,11211,36047054700,170095,0,Census Tract 547,New York,Kings County,1590,3509,2184,2097,0,1310,280,507,87,87,0,42,45,0,1325,659,0,501,158,666,1173,33.4,24.2,0.0,50.3,292237.88671875,2303.8272867240803
48976,11229,11229,36047054800,173220,0,Census Tract 548,New York,Kings County,716,1479,774,740,0,695,21,24,34,34,0,34,0,0,705,490,0,454,36,215,239,16.2,3.2,0.0,30.5,300865.6484375,3175.48326344209
48977,11211,11211,36047054900,195442,0,Census Tract 549,New York,Kings County,2285,3167,2570,2412,0,2190,95,127,158,158,0,127,31,0,597,553,0,527,26,44,171,5.4,5.3,0.0,7.4,340078.03125,2511.4903176262696
48978,11229,11229,36047055000,179814,0,Census Tract 550,New York,Kings County,1403,2696,1592,1470,0,1344,59,67,122,113,0,106,7,9,1104,873,0,858,15,231,307,11.4,4.6,7.4,20.9,312314.84375,2280.16437476762
48979,11211,11211,36047055100,231586,0,Census Tract 551,New York,Kings County,2921,4432,3082,2980,0,2758,163,59,102,102,0,68,34,0,1350,1243,0,1020,223,107,166,3.7,2.0,0.0,7.9,403498.19921875,2833.3168016226
48980,11229,11229,36047055200,167669,0,Census Tract 552,New York,Kings County,1559,2724,1670,1594,0,1484,75,35,76,76,0,76,0,0,1054,838,0,838,0,216,251,9.2,2.2,0.0,20.5,291218.609375,2218.49246125594
48981,11211,11211,36047055300,156271,0,Census Tract 553,New York,Kings County,2112,2605,2199,2124,0,2025,87,12,75,75,0,75,0,0,406,322,0,283,39,84,96,3.7,0.6,0.0,20.7,272297.5859375,2218.41787554414
48982,11229,11229,36047055400,169301,0,Census Tract 554,New York,Kings County,2093,3456,2266,2093,25,1867,201,0,173,173,0,141,32,0,1190,1019,28,976,15,171,171,4.9,0.0,0.0,14.4,294047.3671875,2241.67808383166
48983,11211,11211,36047055500,261680,0,Census Tract 555,New York,Kings County,4976,5851,5169,4976,0,4915,61,0,193,193,0,193,0,0,682,670,14,571,85,12,12,0.2,0.0,0.0,1.8,455988.70703125,2777.1345752073
48984,11223,11223,36047055600,193199,0,Census Tract 556,New York,Kings County,1526,2723,1598,1560,0,1445,81,34,38,38,0,38,0,0,1125,1070,0,1010,60,55,89,3.3,2.2,0.0,4.9,335509.97265625,2359.31619899933
48984,11229,11229,36047055600,193199,0,Census Tract 556,New York,Kings County,1526,2723,1598,1560,0,1445,81,34,38,38,0,38,0,0,1125,1070,0,1010,60,55,89,3.3,2.2,0.0,4.9,335509.97265625,2359.31619899933
48985,11211,11211,36047055700,282493,0,Census Tract 557,New York,Kings County,1305,1786,1373,1305,0,1128,177,0,68,68,0,68,0,0,413,315,0,289,26,98,98,5.5,0.0,0.0,23.7,492307.171875,2840.96068470982
48986,11229,11229,36047055800,171625,0,Census Tract 558,New York,Kings County,1104,1962,1231,1149,0,1018,86,45,82,82,0,67,15,0,731,611,0,573,38,120,165,8.4,3.9,0.0,16.4,298048.09375,2250.20985754178
48987,11229,11229,36047056000,184752,0,Census Tract 560,New York,Kings County,1410,2787,1512,1433,103,1291,16,23,79,79,0,79,0,0,1275,1114,39,986,89,161,184,6.6,1.6,0.0,12.6,320846.55859375,2314.96385982
48988,11211,11211,36047056100,338520,25811,Census Tract 561,New York,Kings County,2243,3044,2343,2268,0,1959,284,25,75,75,0,75,0,0,701,583,0,408,175,118,143,4.7,1.1,0.0,16.8,590132.609375,3340.62135774229
48988,11222,11222,36047056100,338520,25811,Census Tract 561,New York,Kings County,2243,3044,2343,2268,0,1959,284,25,75,75,0,75,0,0,701,583,0,408,175,118,143,4.7,1.1,0.0,16.8,590132.609375,3340.62135774229
48989,11229,11229,36047056200,170814,0,Census Tract 562,New York,Kings County,698,1328,737,698,0,677,21,0,39,39,0,39,0,0,591,544,0,492,52,47,47,3.5,0.0,0.0,8.0,296644.03515625,2246.38013049719
48990,11222,11222,36047056300,370286,67755,Census Tract 563,New York,Kings County,2832,4407,3055,2867,0,2611,221,35,188,188,0,155,33,0,1352,975,161,703,111,377,412,9.3,1.2,0.0,27.9,668618.41796875,3779.6432755202704
48991,11229,11229,36047056400,183221,0,Census Tract 564,New York,Kings County,1125,2053,1258,1176,0,1086,39,51,82,82,0,82,0,0,795,747,0,694,53,48,99,4.8,4.3,0.0,6.0,318215.0078125,2574.97149510582
48992,11222,11222,36047056500,237963,0,Census Tract 565,New York,Kings County,1938,2715,2009,1938,0,1895,43,0,71,63,0,63,0,8,706,505,0,420,85,201,209,7.7,0.0,11.3,28.5,414811.0,2730.54440016145
48993,11229,11229,36047056600,171530,0,Census Tract 566,New York,Kings County,1374,2235,1471,1401,0,1330,44,27,70,70,0,70,0,0,764,593,0,565,28,171,198,8.9,1.9,0.0,22.4,297875.88671875,2241.36187670224
48994,11229,11229,36047056800,117817,0,Census Tract 568,New York,Kings County,884,1299,934,902,0,866,18,18,32,32,0,32,0,0,365,308,0,303,5,57,75,5.8,2.0,0.0,15.6,204597.6875,2097.72622775717
48995,11211,11211,36047056900,127954,0,Census Tract 569,New York,Kings County,1060,1403,1117,1086,0,1034,26,26,31,31,0,31,0,0,286,241,0,214,27,45,71,5.1,2.4,0.0,15.7,223004.328125,2307.41682400159
48995,11222,11222,36047056900,127954,0,Census Tract 569,New York,Kings County,1060,1403,1117,1086,0,1034,26,26,31,31,0,31,0,0,286,241,0,214,27,45,71,5.1,2.4,0.0,15.7,223004.328125,2307.41682400159
48996,11229,11229,36047057000,262372,0,Census Tract 570,New York,Kings County,1562,2968,1707,1621,0,1528,34,59,86,86,0,86,0,0,1261,1126,0,1098,28,135,194,6.5,3.6,0.0,10.7,455580.34375,3472.97621147617
48997,11222,11222,36047057100,175867,0,Census Tract 571,New York,Kings County,2341,3583,2532,2385,0,2302,39,44,147,147,0,147,0,0,1051,838,0,705,133,213,257,7.2,1.8,0.0,20.3,306517.26953125,2219.87798604828
48998,11229,11229,36047057200,243629,0,Census Tract 572,New York,Kings County,1461,4170,2202,1863,0,1365,96,402,339,295,0,259,36,44,1968,1324,0,1302,22,644,1090,26.1,21.6,13.0,32.7,422999.61328125,2607.24924146037
48999,11222,11222,36047057300,170142,0,Census Tract 573,New York,Kings County,1638,2183,1750,1655,39,1567,32,17,95,95,0,95,0,0,433,291,0,279,12,142,159,7.3,1.0,0.0,32.8,296567.80078125,2263.57171741686
49000,11229,11229,36047057400,159204,0,Census Tract 574,New York,Kings County,1293,2434,1417,1363,0,1261,32,70,54,54,0,54,0,0,1017,943,4,913,26,74,144,5.9,5.1,0.0,7.3,276453.7578125,2629.12052829477
49001,11222,11222,36047057500,181405,0,Census Tract 575,New York,Kings County,2419,3369,2553,2437,0,2215,204,18,116,116,0,116,0,0,816,717,38,489,190,99,117,3.5,0.7,0.0,12.1,316238.6328125,2817.83274226511
49002,11229,11229,36047057600,158605,0,Census Tract 576,New York,Kings County,1391,2509,1547,1482,6,1366,19,91,65,65,0,60,5,0,962,770,5,684,81,192,283,11.3,6.1,0.0,20.0,275403.5703125,2146.4472107484
49003,11229,11229,36047057800,172233,0,Census Tract 578,New York,Kings County,1342,2698,1578,1492,0,1325,17,150,86,86,0,86,0,0,1120,855,0,812,43,265,415,15.4,10.1,0.0,23.7,299065.78125,2218.72819431207
49004,11222,11222,36047057900,749113,51764,Census Tract 579,New York,Kings County,721,929,721,721,0,625,96,0,0,0,0,0,0,0,208,189,0,139,50,19,19,2.0,0.0,,9.1,1192784.875,6473.6451573104005
49005,11229,11229,36047058000,158641,0,Census Tract 580,New York,Kings County,1876,3343,2006,1952,0,1834,42,76,54,54,0,54,0,0,1337,1157,7,1032,118,180,256,7.7,3.9,0.0,13.5,275462.125,2145.62937875133
49006,11223,11223,36047058200,161534,0,Census Tract 582,New York,Kings County,1248,2125,1345,1305,0,1151,97,57,40,40,0,40,0,0,780,657,0,589,68,123,180,8.5,4.4,0.0,15.8,280481.953125,2164.9359691394397
49006,11229,11229,36047058200,161534,0,Census Tract 582,New York,Kings County,1248,2125,1345,1305,0,1151,97,57,40,40,0,40,0,0,780,657,0,589,68,123,180,8.5,4.4,0.0,15.8,280481.953125,2164.9359691394397
49007,11223,11223,36047058400,188224,0,Census Tract 584,New York,Kings County,1623,2847,1796,1690,0,1569,54,67,106,106,0,106,0,0,1051,827,0,771,56,224,291,10.2,4.0,0.0,21.3,326780.23046875,2316.9876095332
49007,11229,11229,36047058400,188224,0,Census Tract 584,New York,Kings County,1623,2847,1796,1690,0,1569,54,67,106,106,0,106,0,0,1051,827,0,771,56,224,291,10.2,4.0,0.0,21.3,326780.23046875,2316.9876095332
49008,11229,11229,36047058600,163424,0,Census Tract 586,New York,Kings County,1327,2357,1412,1360,0,1327,0,33,52,52,0,49,3,0,945,879,0,868,11,66,99,4.2,2.4,0.0,7.0,283730.91015625,2186.41175656738
49009,11235,11235,36047058800,159609,0,Census Tract 588,New York,Kings County,1656,2806,1846,1706,0,1611,45,50,140,140,0,140,0,0,960,732,0,725,7,228,278,9.9,2.9,0.0,23.8,277064.3515625,2139.39906771618
49010,11222,11222,36047058900,424025,38353,Census Tract 589,New York,Kings County,979,1500,1035,985,19,933,27,6,50,50,0,50,0,0,465,340,18,253,69,125,131,8.7,0.6,0.0,26.9,753775.8203125,4844.14329501424
49011,11235,11235,36047059000,158383,0,Census Tract 590,New York,Kings County,835,1598,891,850,0,821,14,15,41,41,0,19,22,0,707,670,0,626,44,37,52,3.3,1.8,0.0,5.2,274939.6015625,2320.5545300956
49012,11222,11222,36047059100,192105,0,Census Tract 591,New York,Kings County,2810,3674,2968,2840,17,2675,118,30,128,119,0,119,0,9,706,612,6,440,166,94,133,3.6,1.1,7.0,13.3,334801.80078125,2388.73086664033
49013,11229,11229,36047059200,219306,0,Census Tract 592,New York,Kings County,1967,3558,2051,1975,0,1883,84,8,76,76,0,76,0,0,1507,1250,7,1149,94,257,265,7.4,0.4,0.0,17.1,380721.33203125,3290.8823434936894
49013,11235,11235,36047059200,219306,0,Census Tract 592,New York,Kings County,1967,3558,2051,1975,0,1883,84,8,76,76,0,76,0,0,1507,1250,7,1149,94,257,265,7.4,0.4,0.0,17.1,380721.33203125,3290.8823434936894
49014,11222,11222,36047059300,187979,0,Census Tract 593,New York,Kings County,1282,1930,1387,1282,0,1176,106,0,105,105,0,105,0,0,543,487,0,454,33,56,56,2.9,0.0,0.0,10.3,327636.46875,2438.17054055171
49015,11229,11229,36047059401,420618,0,Census Tract 594.01,New York,Kings County,3838,6409,4159,3944,0,3748,90,106,215,215,0,215,0,0,2250,1971,0,1765,206,279,385,6.0,2.7,0.0,12.4,730221.6484375,3881.7211491539397
49015,11235,11235,36047059401,420618,0,Census Tract 594.01,New York,Kings County,3838,6409,4159,3944,0,3748,90,106,215,215,0,215,0,0,2250,1971,0,1765,206,279,385,6.0,2.7,0.0,12.4,730221.6484375,3881.7211491539397
49016,11229,11229,36047059402,322473,0,Census Tract 594.02,New York,Kings County,2606,4418,2826,2662,0,2573,33,56,164,164,0,158,6,0,1592,1363,0,1309,54,229,285,6.5,2.1,0.0,14.4,559864.6328125,3252.2859587076696
49016,11235,11235,36047059402,322473,0,Census Tract 594.02,New York,Kings County,2606,4418,2826,2662,0,2573,33,56,164,164,0,158,6,0,1592,1363,0,1309,54,229,285,6.5,2.1,0.0,14.4,559864.6328125,3252.2859587076696
49017,11235,11235,36047059600,173084,0,Census Tract 596,New York,Kings County,1118,2098,1224,1175,0,958,160,57,49,49,0,39,10,0,874,704,0,534,170,170,227,10.8,4.9,0.0,19.5,300468.109375,2750.8781683117
49018,11235,11235,36047059800,199216,0,Census Tract 598,New York,Kings County,1715,2692,1926,1757,7,1688,20,42,169,169,0,160,9,0,766,685,7,644,34,81,123,4.6,2.4,0.0,10.6,345800.6875,2910.33080327997
49019,11235,11235,36047060000,439917,0,Census Tract 600,New York,Kings County,3460,5451,3654,3474,0,3437,23,14,180,180,0,169,11,0,1797,1416,0,1343,73,381,395,7.2,0.4,0.0,21.2,763593.359375,3871.92936511909
49020,11235,11235,36047060600,179266,0,Census Tract 606,New York,Kings County,1155,2395,1336,1228,0,1090,65,73,108,108,0,96,12,0,1059,821,0,779,42,238,311,13.0,5.9,0.0,22.5,311161.19921875,3044.09050998687
49021,11235,11235,36047060800,401159,119875,Census Tract 608,New York,Kings County,1728,2814,1869,1751,0,1636,92,23,118,118,0,109,9,0,945,718,0,718,0,227,250,8.9,1.3,0.0,24.0,695314.85546875,6992.041640898199
49022,11235,11235,36047061002,227269,298539,Census Tract 610.02,New York,Kings County,2093,3431,2093,2093,0,2032,61,0,0,0,0,0,0,0,1338,1025,0,951,74,313,313,9.1,0.0,,23.4,384801.6484375,2910.59490493901
49023,11235,11235,36047061003,80173,0,Census Tract 610.03,New York,Kings County,655,1448,758,706,0,623,32,51,52,52,0,52,0,0,690,619,0,589,30,71,122,8.4,7.2,0.0,10.3,139140.45703125,1854.66660401409
49024,11235,11235,36047061004,224494,0,Census Tract 610.04,New York,Kings County,2342,5282,2471,2429,0,2127,215,87,42,42,0,42,0,0,2811,1905,26,1499,380,906,993,18.8,3.6,0.0,32.2,389583.62890625,2845.2066458547697
49025,11235,11235,36047061200,198236,39403,Census Tract 612,New York,Kings County,510,874,545,536,0,499,11,26,9,9,0,9,0,0,329,292,4,277,11,37,63,7.2,4.9,0.0,11.2,344024.78125,2879.61559927354
49026,11235,11235,36047061600,726087,933068,Census Tract 616,New York,Kings County,388,888,433,392,0,378,10,4,41,41,0,41,0,0,455,374,0,359,15,81,85,9.6,1.0,0.0,17.8,1280333.7421875,6520.668787385
49027,11235,11235,36047062000,319578,34799,Census Tract 620,New York,Kings County,893,1511,944,900,0,889,4,7,44,44,0,44,0,0,567,516,0,516,0,51,58,3.8,0.8,0.0,9.0,560593.97265625,3846.1795778103
49028,11235,11235,36047062200,247463,107697,Census Tract 622,New York,Kings County,1336,2008,1430,1352,0,1295,41,16,78,78,0,78,0,0,578,434,0,379,55,144,160,8.0,1.2,0.0,24.9,422472.50390625,3349.72598885791
49029,11229,11229,36047062600,318165,0,Census Tract 626,New York,Kings County,1088,2334,1236,1125,0,1063,25,37,111,111,0,108,3,0,1098,991,0,936,55,107,144,6.2,3.3,0.0,9.7,552345.22265625,4019.4519097773705
49029,11235,11235,36047062600,318165,0,Census Tract 626,New York,Kings County,1088,2334,1236,1125,0,1063,25,37,111,111,0,108,3,0,1098,991,0,936,55,107,144,6.2,3.3,0.0,9.7,552345.22265625,4019.4519097773705
49030,11229,11229,36047062800,767457,272494,Census Tract 628,New York,Kings County,1822,3759,2225,1951,0,1727,95,129,274,274,0,263,11,0,1534,1267,0,1168,99,267,396,10.5,6.6,0.0,17.4,1368857.515625,14370.667893771899
49030,11235,11235,36047062800,767457,272494,Census Tract 628,New York,Kings County,1822,3759,2225,1951,0,1727,95,129,274,274,0,263,11,0,1534,1267,0,1168,99,267,396,10.5,6.6,0.0,17.4,1368857.515625,14370.667893771899
49031,11229,11229,36047063200,117438,0,Census Tract 632,New York,Kings County,658,1333,759,670,0,624,34,12,89,89,0,89,0,0,574,414,0,360,54,160,172,12.9,1.8,0.0,27.9,203921.828125,2311.18013748787
49032,11234,11234,36047063600,114322,0,Census Tract 636,New York,Kings County,630,1219,704,630,0,605,25,0,74,74,0,69,5,0,515,491,0,469,22,24,24,2.0,0.0,0.0,4.7,198571.171875,2101.39476242883
49033,11229,11229,36047063800,139202,0,Census Tract 638,New York,Kings County,909,1530,979,940,0,904,5,31,39,39,0,39,0,0,551,487,0,467,20,64,95,6.2,3.3,0.0,11.6,241758.73828125,3376.07425965421
49034,11229,11229,36047064000,153400,0,Census Tract 640,New York,Kings County,782,1355,800,794,0,738,44,12,6,6,0,6,0,0,555,503,0,457,46,52,64,4.7,1.5,0.0,9.4,266453.77734375,2303.50347323489
49034,11234,11234,36047064000,153400,0,Census Tract 640,New York,Kings County,782,1355,800,794,0,738,44,12,6,6,0,6,0,0,555,503,0,457,46,52,64,4.7,1.5,0.0,9.4,266453.77734375,2303.50347323489
49035,11210,11210,36047064200,235070,0,Census Tract 642,New York,Kings County,896,1817,965,909,0,893,3,13,56,56,0,56,0,0,852,753,0,738,15,99,112,6.2,1.4,0.0,11.6,408330.73828125,2756.11812480549
49035,11229,11229,36047064200,235070,0,Census Tract 642,New York,Kings County,896,1817,965,909,0,893,3,13,56,56,0,56,0,0,852,753,0,738,15,99,112,6.2,1.4,0.0,11.6,408330.73828125,2756.11812480549
49036,11229,11229,36047064400,199333,0,Census Tract 644,New York,Kings County,1304,2011,1323,1304,0,1285,19,0,19,19,0,19,0,0,688,633,0,618,15,55,55,2.7,0.0,0.0,8.0,346270.88671875,2615.33095701996
49036,11234,11234,36047064400,199333,0,Census Tract 644,New York,Kings County,1304,2011,1323,1304,0,1285,19,0,19,19,0,19,0,0,688,633,0,618,15,55,55,2.7,0.0,0.0,8.0,346270.88671875,2615.33095701996
49037,11234,11234,36047064600,165636,0,Census Tract 646,New York,Kings County,825,1589,909,865,0,758,67,40,44,38,0,27,11,6,680,601,0,538,63,79,125,7.9,4.6,13.6,11.6,287748.55078125,2257.5412526240602
49038,11234,11234,36047064800,151522,0,Census Tract 648,New York,Kings County,921,1563,1014,970,10,883,28,49,44,44,5,35,4,0,549,483,16,460,7,66,115,7.4,5.1,0.0,12.0,263246.91015625,2095.97248372388
49039,11234,11234,36047065000,166228,0,Census Tract 650,New York,Kings County,749,1277,846,754,0,635,114,5,92,86,0,86,0,6,431,382,0,352,30,49,60,4.7,0.7,6.5,11.4,288817.80859375,2318.08633121568
49040,11234,11234,36047065200,174713,0,Census Tract 652,New York,Kings County,540,1007,552,540,0,516,24,0,12,12,0,12,0,0,455,440,0,341,99,15,15,1.5,0.0,0.0,3.3,303507.7421875,2537.5022453116603
49041,11234,11234,36047065400,151523,0,Census Tract 654,New York,Kings County,669,1240,740,669,0,632,37,0,71,71,0,71,0,0,500,466,0,423,43,34,34,2.7,0.0,0.0,6.8,263212.0546875,2723.9581803149
49042,11234,11234,36047065600,153578,0,Census Tract 656,New York,Kings County,781,1354,790,786,0,749,32,5,4,4,0,4,0,0,564,461,0,428,33,103,108,8.0,0.6,0.0,18.3,266777.97265625,2103.62757744118
49043,11234,11234,36047065800,153365,0,Census Tract 658,New York,Kings County,869,1624,926,869,0,869,0,0,57,57,0,57,0,0,698,627,0,594,33,71,71,4.4,0.0,0.0,10.2,266369.18359375,2520.30370716186
49044,11234,11234,36047066000,152314,0,Census Tract 660,New York,Kings County,1006,1725,1087,1019,0,938,68,13,68,68,0,68,0,0,638,584,0,512,72,54,67,3.9,1.3,0.0,8.5,264555.22265625,2098.46460099824
49045,11234,11234,36047066200,231462,0,Census Tract 662,New York,Kings County,752,1423,847,752,0,752,0,0,95,95,0,90,5,0,576,477,0,456,21,99,99,7.0,0.0,0.0,17.2,402029.9609375,3307.4955017889
49046,11229,11229,36047066600,4047419,5809817,Census Tract 666,New York,Kings County,0,0,0,0,0,0,0,0,0,0,0,0,0,0,0,0,0,0,0,0,0,,,,,7530807.11328125,37456.3026271239
49046,11234,11234,36047066600,4047419,5809817,Census Tract 666,New York,Kings County,0,0,0,0,0,0,0,0,0,0,0,0,0,0,0,0,0,0,0,0,0,,,,,7530807.11328125,37456.3026271239
49047,11234,11234,36047067000,208266,0,Census Tract 670,New York,Kings County,1433,2352,1619,1488,0,1319,114,55,131,119,0,112,7,12,733,593,0,582,11,140,207,8.8,3.7,9.2,19.1,361774.68359375,2489.47107702161
49048,11234,11234,36047067200,174237,0,Census Tract 672,New York,Kings County,702,1316,832,781,0,673,29,79,51,51,0,51,0,0,484,459,0,436,23,25,104,7.9,10.1,0.0,5.2,302716.61328125,3342.88130657182
49049,11234,11234,36047067400,189209,0,Census Tract 674,New York,Kings County,1034,1556,1099,1053,0,1022,12,19,46,44,0,44,0,2,457,430,0,401,29,27,48,3.1,1.8,4.3,5.9,328741.29296875,2909.21504656149
49050,11234,11234,36047067600,155374,0,Census Tract 676,New York,Kings County,874,1516,998,894,0,761,113,20,104,81,0,75,6,23,518,482,0,426,56,36,79,5.2,2.2,22.1,6.9,269998.21875,2552.02229952035
49051,11234,11234,36047067800,166222,0,Census Tract 678,New York,Kings County,1251,2220,1524,1334,0,1132,119,83,190,190,0,190,0,0,696,603,0,581,22,93,176,7.9,6.2,0.0,13.4,288855.92578125,2177.1691769155
49052,11234,11234,36047068000,168859,0,Census Tract 680,New York,Kings County,1169,1819,1279,1208,0,1112,57,39,71,71,0,71,0,0,540,513,0,502,11,27,66,3.6,3.2,0.0,5.0,293399.01171875,2221.59563419464
49053,11234,11234,36047068200,202229,0,Census Tract 682,New York,Kings County,1515,2483,1708,1579,0,1337,178,64,129,90,0,90,0,39,775,659,0,619,40,116,219,8.8,4.1,30.2,15.0,351328.21875,2606.0285866058803
49054,11234,11234,36047068600,148006,0,Census Tract 686,New York,Kings County,813,1430,914,844,0,773,40,31,70,65,7,42,16,5,516,444,11,378,55,72,108,7.6,3.7,7.1,14.0,257114.71484375,2511.67999103239
49055,11234,11234,36047068800,156912,0,Census Tract 688,New York,Kings County,818,1373,844,818,0,769,49,0,26,26,0,26,0,0,529,434,0,374,60,95,95,6.9,0.0,0.0,18.0,272607.50390625,2228.7097780329
49056,11234,11234,36047069000,172913,0,Census Tract 690,New York,Kings County,1037,1753,1146,1058,0,960,77,21,88,88,0,88,0,0,607,523,0,498,25,84,105,6.0,2.0,0.0,13.8,300430.9140625,2677.06642989983
49057,11234,11234,36047069200,182215,0,Census Tract 692,New York,Kings County,1509,2231,1636,1517,17,1419,73,8,119,119,0,86,33,0,595,571,6,504,61,24,32,1.4,0.5,0.0,4.0,316627.375,2607.2961462191897
49058,11234,11234,36047069601,456923,47776,Census Tract 696.01,New York,Kings County,1952,3088,2161,1962,0,1782,170,10,199,199,0,146,53,0,927,822,0,702,120,105,115,3.7,0.5,0.0,11.3,794045.0546875,4065.3206939189295
49059,11234,11234,36047069602,688168,172866,Census Tract 696.02,New York,Kings County,2600,4953,2784,2718,0,2486,114,118,66,66,0,66,0,0,2169,2072,0,1907,165,97,215,4.3,4.3,0.0,4.5,1195741.75,5957.25309419515
49060,11234,11234,36047069800,500249,120721,Census Tract 698,New York,Kings County,706,1138,715,706,0,706,0,0,9,9,0,9,0,0,423,403,0,403,0,20,20,1.8,0.0,0.0,4.7,869517.69921875,7993.777586418041
49061,11234,11234,36047070000,201893,0,Census Tract 700,New York,Kings County,734,1298,824,786,0,708,26,52,38,38,0,34,4,0,474,377,0,364,13,97,149,11.5,6.6,0.0,20.5,350783.484375,2467.43585521738
49062,11234,11234,36047070201,1074076,177944,Census Tract 702.01,New York,Kings County,2697,4862,2905,2791,0,2630,67,94,114,114,0,114,0,0,1957,1674,0,1560,114,283,377,7.8,3.4,0.0,14.5,1865287.234375,6915.40226618421
49063,11234,11234,36047070202,5162435,1735262,Census Tract 702.02,New York,Kings County,24,24,24,24,0,24,0,0,0,0,0,0,0,0,0,0,0,0,0,0,0,0.0,0.0,,,9056304.82421875,14535.2241573214
49065,11234,11234,36047070600,1650185,903173,Census Tract 706,New York,Kings County,1237,2399,1303,1237,0,1194,43,0,66,66,0,66,0,0,1096,1025,0,1006,19,71,71,3.0,0.0,0.0,6.5,2867448.05859375,7719.1747583144
49066,11234,11234,36047072000,158228,0,Census Tract 720,New York,Kings County,975,1671,1115,1013,0,835,140,38,102,90,0,83,7,12,556,542,0,457,85,14,64,3.8,3.8,11.8,2.5,274985.8203125,2685.32372150348
49067,11234,11234,36047072200,257178,0,Census Tract 722,New York,Kings County,1270,2458,1438,1299,6,1244,20,29,139,119,0,119,0,20,1020,837,0,823,14,183,232,9.4,2.2,14.4,17.9,446999.34765625,3381.1654448938
49067,11236,11236,36047072200,257178,0,Census Tract 722,New York,Kings County,1270,2458,1438,1299,6,1244,20,29,139,119,0,119,0,20,1020,837,0,823,14,183,232,9.4,2.2,14.4,17.9,446999.34765625,3381.1654448938
49068,11234,11234,36047072400,192192,0,Census Tract 724,New York,Kings County,846,1585,947,877,0,787,59,31,70,70,0,58,12,0,638,587,0,545,42,51,82,5.2,3.5,0.0,8.0,334067.34765625,2629.67664041271
49069,11203,11203,36047072600,275168,0,Census Tract 726,New York,Kings County,1004,1861,1123,1042,0,1004,0,38,81,81,0,81,0,0,738,674,0,674,0,64,102,5.5,3.6,0.0,8.7,478268.34375,2874.6635044456298
49069,11210,11210,36047072600,275168,0,Census Tract 726,New York,Kings County,1004,1861,1123,1042,0,1004,0,38,81,81,0,81,0,0,738,674,0,674,0,64,102,5.5,3.6,0.0,8.7,478268.34375,2874.6635044456298
49069,11234,11234,36047072600,275168,0,Census Tract 726,New York,Kings County,1004,1861,1123,1042,0,1004,0,38,81,81,0,81,0,0,738,674,0,674,0,64,102,5.5,3.6,0.0,8.7,478268.34375,2874.6635044456298
49070,11234,11234,36047072800,212050,0,Census Tract 728,New York,Kings County,1488,3153,1793,1557,0,1422,66,69,236,224,0,194,30,12,1360,1123,10,1009,104,237,318,10.1,4.4,5.1,17.4,368529.625,3037.62060776689
49071,11234,11234,36047073000,185015,0,Census Tract 730,New York,Kings County,1093,1909,1241,1105,0,1068,25,12,136,136,0,136,0,0,668,550,0,501,49,118,130,6.8,1.1,0.0,17.7,321517.984375,3107.54325733425
49072,11210,11210,36047073200,160035,0,Census Tract 732,New York,Kings County,946,1936,1094,993,0,862,84,47,101,68,0,68,0,33,842,722,0,630,92,120,200,10.3,4.7,32.7,14.3,278118.40234375,2229.21437082088
49072,11234,11234,36047073200,160035,0,Census Tract 732,New York,Kings County,946,1936,1094,993,0,862,84,47,101,68,0,68,0,33,842,722,0,630,92,120,200,10.3,4.7,32.7,14.3,278118.40234375,2229.21437082088
49073,11210,11210,36047073400,151105,0,Census Tract 734,New York,Kings County,885,1652,970,904,0,852,33,19,66,66,0,53,13,0,682,642,0,632,10,40,59,3.6,2.1,0.0,5.9,262601.15625,2085.25550781504
49074,11210,11210,36047073600,178018,0,Census Tract 736,New York,Kings County,1619,2749,1791,1659,0,1554,65,40,132,132,0,132,0,0,958,856,0,856,0,102,142,5.2,2.4,0.0,10.6,309336.90234375,2333.92469687487
49074,11234,11234,36047073600,178018,0,Census Tract 736,New York,Kings County,1619,2749,1791,1659,0,1554,65,40,132,132,0,132,0,0,958,856,0,856,0,102,142,5.2,2.4,0.0,10.6,309336.90234375,2333.92469687487
49075,11210,11210,36047073800,180579,0,Census Tract 738,New York,Kings County,1548,2910,1765,1676,0,1406,142,128,89,61,0,61,0,28,1145,1008,0,965,43,137,293,10.1,7.6,31.5,12.0,313770.73828125,2330.52456985051
49075,11234,11234,36047073800,180579,0,Census Tract 738,New York,Kings County,1548,2910,1765,1676,0,1406,142,128,89,61,0,61,0,28,1145,1008,0,965,43,137,293,10.1,7.6,31.5,12.0,313770.73828125,2330.52456985051
49076,11210,11210,36047074000,162388,0,Census Tract 740,New York,Kings County,1592,2948,1832,1713,0,1504,88,121,119,119,0,119,0,0,1116,1017,0,973,44,99,220,7.5,7.1,0.0,8.9,282204.2109375,2257.12719008813
49077,11210,11210,36047074200,174327,0,Census Tract 742,New York,Kings County,1390,2450,1521,1420,0,1283,107,30,101,101,0,101,0,0,929,850,0,758,92,79,109,4.4,2.1,0.0,8.5,302949.921875,2276.8853566329603
49078,11210,11210,36047074400,170075,0,Census Tract 744,New York,Kings County,1014,1817,1045,1014,0,965,49,0,31,31,0,31,0,0,772,764,0,751,13,8,8,0.4,0.0,0.0,1.0,295519.84375,2287.0762458652202
49079,11210,11210,36047074600,202040,0,Census Tract 746,New York,Kings County,1228,1941,1301,1241,0,1173,55,13,60,60,0,60,0,0,640,605,0,578,27,35,48,2.5,1.0,0.0,5.5,351019.58984375,3135.6637423697102
49079,11234,11234,36047074600,202040,0,Census Tract 746,New York,Kings County,1228,1941,1301,1241,0,1173,55,13,60,60,0,60,0,0,640,605,0,578,27,35,48,2.5,1.0,0.0,5.5,351019.58984375,3135.6637423697102
49080,11210,11210,36047074800,176549,0,Census Tract 748,New York,Kings County,829,1320,870,849,0,808,21,20,21,21,0,21,0,0,450,374,0,346,28,76,96,7.3,2.4,0.0,16.9,306762.85546875,2283.0726961359696
49081,11210,11210,36047075000,173420,0,Census Tract 750,New York,Kings County,1061,1951,1201,1125,6,906,149,64,76,76,14,62,0,0,750,669,0,648,21,81,145,7.4,5.7,0.0,10.8,301370.05078125,2266.79717885828
49082,11210,11210,36047075200,173194,0,Census Tract 752,New York,Kings County,483,828,502,493,0,457,26,10,9,9,0,9,0,0,326,304,0,257,47,22,32,3.9,2.0,0.0,6.7,300975.55078125,2266.8524101319604
49083,11210,11210,36047075400,173457,0,Census Tract 754,New York,Kings County,593,1036,608,593,0,529,64,0,15,15,0,15,0,0,428,413,0,334,79,15,15,1.4,0.0,0.0,3.5,301387.97265625,2267.0500585743603
49084,11210,11210,36047075600,173546,0,Census Tract 756,New York,Kings County,920,1491,983,942,0,905,15,22,41,41,0,41,0,0,508,440,0,421,19,68,90,6.0,2.3,0.0,13.4,301503.953125,2245.09730767168
49084,11229,11229,36047075600,173546,0,Census Tract 756,New York,Kings County,920,1491,983,942,0,905,15,22,41,41,0,41,0,0,508,440,0,421,19,68,90,6.0,2.3,0.0,13.4,301503.953125,2245.09730767168
49085,11210,11210,36047075800,205258,0,Census Tract 758,New York,Kings County,651,1395,787,661,0,573,78,10,126,126,0,88,38,0,608,542,0,422,120,66,76,5.4,1.5,0.0,10.9,356588.9140625,2571.30448836003
49085,11230,11230,36047075800,205258,0,Census Tract 758,New York,Kings County,651,1395,787,661,0,573,78,10,126,126,0,88,38,0,608,542,0,422,120,66,76,5.4,1.5,0.0,10.9,356588.9140625,2571.30448836003
49086,11210,11210,36047076000,181582,0,Census Tract 760,New York,Kings County,1074,2142,1157,1107,0,927,147,33,50,50,0,42,8,0,985,861,0,688,173,124,157,7.3,3.0,0.0,12.6,315503.765625,2549.62977003263
49086,11230,11230,36047076000,181582,0,Census Tract 760,New York,Kings County,1074,2142,1157,1107,0,927,147,33,50,50,0,42,8,0,985,861,0,688,173,124,157,7.3,3.0,0.0,12.6,315503.765625,2549.62977003263
49087,11210,11210,36047076200,188043,0,Census Tract 762,New York,Kings County,2010,3525,2182,2148,53,1852,105,138,34,34,0,24,10,0,1343,1063,114,882,67,280,418,11.9,6.4,0.0,20.8,326771.1796875,2340.73437854508
49087,11230,11230,36047076200,188043,0,Census Tract 762,New York,Kings County,2010,3525,2182,2148,53,1852,105,138,34,34,0,24,10,0,1343,1063,114,882,67,280,418,11.9,6.4,0.0,20.8,326771.1796875,2340.73437854508
49088,11230,11230,36047076400,161588,0,Census Tract 764,New York,Kings County,2032,3022,2199,2100,11,1837,184,68,99,99,0,72,27,0,823,609,0,551,58,214,282,9.3,3.2,0.0,26.0,280853.4296875,2830.09608769563
49089,11210,11210,36047076600,82578,0,Census Tract 766,New York,Kings County,1136,1893,1237,1158,0,1076,60,22,79,71,0,54,17,8,656,650,0,562,88,6,36,1.9,1.9,10.1,0.9,143532.94921875,1811.31162192478
49089,11230,11230,36047076600,82578,0,Census Tract 766,New York,Kings County,1136,1893,1237,1158,0,1076,60,22,79,71,0,54,17,8,656,650,0,562,88,6,36,1.9,1.9,10.1,0.9,143532.94921875,1811.31162192478
49090,11230,11230,36047076800,303359,0,Census Tract 768,New York,Kings County,1318,2417,1496,1384,0,1056,262,66,112,112,0,104,8,0,921,714,0,480,234,207,273,11.3,4.8,0.0,22.5,527058.26953125,3617.49378108761
49091,11210,11210,36047077000,163284,0,Census Tract 770,New York,Kings County,1275,2062,1424,1327,0,1204,71,52,97,97,0,47,50,0,638,596,0,570,26,42,94,4.6,3.9,0.0,6.6,283835.97265625,2861.03480278628
49092,11210,11210,36047077200,404333,0,Census Tract 772,New York,Kings County,1432,2365,1593,1526,0,1381,51,94,67,67,0,67,0,0,772,697,0,649,48,75,169,7.1,6.2,0.0,9.7,702755.828125,4174.68437388665
49092,11230,11230,36047077200,404333,0,Census Tract 772,New York,Kings County,1432,2365,1593,1526,0,1381,51,94,67,67,0,67,0,0,772,697,0,649,48,75,169,7.1,6.2,0.0,9.7,702755.828125,4174.68437388665
49093,11210,11210,36047077400,147764,0,Census Tract 774,New York,Kings County,1695,2747,1918,1750,0,1562,133,55,168,168,0,168,0,0,829,819,0,785,34,10,65,2.4,3.1,0.0,1.2,256820.875,3142.0301868193105
49094,11210,11210,36047077600,186545,0,Census Tract 776,New York,Kings County,1980,3209,2163,1995,0,1891,89,15,168,168,0,168,0,0,1046,870,0,822,48,176,191,6.0,0.8,0.0,16.8,324216.54296875,2639.28042812999
49095,11210,11210,36047078000,164534,0,Census Tract 780,New York,Kings County,1174,1848,1267,1191,0,1160,14,17,76,71,0,71,0,5,581,520,0,470,50,61,83,4.5,1.4,6.6,10.5,285996.0,2200.91657731683
49096,11210,11210,36047078200,168304,0,Census Tract 782,New York,Kings County,2155,3959,2504,2304,0,1938,217,149,200,160,0,160,0,40,1455,1361,0,1201,160,94,283,7.1,6.5,20.0,6.5,292578.22265625,2388.52432250852
49097,11210,11210,36047078400,167427,0,Census Tract 784,New York,Kings County,1224,2098,1359,1308,0,1193,31,84,51,51,0,51,0,0,739,666,0,638,28,73,157,7.5,6.4,0.0,9.9,291020.73046875,2214.99665686998
49098,11210,11210,36047078600,171071,0,Census Tract 786,New York,Kings County,2188,3732,2685,2396,0,2040,148,208,289,272,0,237,35,17,1047,853,0,734,119,194,419,11.2,8.7,5.9,18.5,297357.2890625,2374.51797511317
49099,11210,11210,36047078800,157114,0,Census Tract 788,New York,Kings County,1410,2453,1585,1464,0,1073,337,54,121,121,0,109,12,0,868,772,0,604,168,96,150,6.1,3.7,0.0,11.1,273120.02734375,2372.85502867448
49100,11226,11226,36047079000,182988,0,Census Tract 790,New York,Kings County,1947,3976,2288,2191,31,1685,231,244,97,97,0,83,14,0,1688,1333,0,1002,331,355,599,15.1,11.1,0.0,21.0,318134.87890625,2395.01471518896
49101,11226,11226,36047079200,216691,0,Census Tract 792,New York,Kings County,1408,2515,1824,1681,0,1290,118,273,143,90,0,90,0,53,691,458,0,413,45,233,559,22.2,16.2,37.1,33.7,376769.73828125,2453.97799391973
49102,11226,11226,36047079400,222181,0,Census Tract 794,New York,Kings County,640,1338,758,720,0,600,40,80,38,38,0,38,0,0,580,421,0,355,66,159,239,17.9,11.1,0.0,27.4,386360.06640625,2517.85913942346
49103,11225,11225,36047079601,110399,0,Census Tract 796.01,New York,Kings County,2525,4126,2772,2574,0,2359,166,49,198,170,0,158,12,28,1354,1059,0,980,79,295,372,9.0,1.9,14.1,21.8,192022.625,1761.99566517441
49103,11226,11226,36047079601,110399,0,Census Tract 796.01,New York,Kings County,2525,4126,2772,2574,0,2359,166,49,198,170,0,158,12,28,1354,1059,0,980,79,295,372,9.0,1.9,14.1,21.8,192022.625,1761.99566517441
49104,11226,11226,36047079602,134994,0,Census Tract 796.02,New York,Kings County,2135,3730,2423,2269,10,1875,250,134,154,137,0,117,20,17,1307,1059,0,760,299,248,399,10.7,5.9,11.0,19.0,234774.52734375,2028.58036442263
49105,11225,11225,36047079801,129680,0,Census Tract 798.01,New York,Kings County,1746,2397,1855,1759,0,1674,72,13,96,84,0,84,0,12,542,444,0,388,56,98,123,5.1,0.7,12.5,18.1,225581.3125,1915.83475735395
49106,11225,11225,36047079802,106372,0,Census Tract 798.02,New York,Kings County,3240,4939,3661,3411,0,2985,255,171,250,208,0,208,0,42,1278,978,0,800,178,300,513,10.4,5.0,16.8,23.5,185025.73828125,2120.35941462531
49106,11226,11226,36047079802,106372,0,Census Tract 798.02,New York,Kings County,3240,4939,3661,3411,0,2985,255,171,250,208,0,208,0,42,1278,978,0,800,178,300,513,10.4,5.0,16.8,23.5,185025.73828125,2120.35941462531
49107,11225,11225,36047080000,173679,0,Census Tract 800,New York,Kings County,1718,3187,2213,1960,0,1675,43,242,253,253,0,253,0,0,974,737,8,722,7,237,479,15.0,12.3,0.0,24.3,302125.34375,2260.64555374142
49108,11225,11225,36047080200,185243,0,Census Tract 802,New York,Kings County,2318,4096,2739,2537,0,2223,95,219,202,148,0,111,37,54,1357,996,0,908,88,361,634,15.5,8.6,26.7,26.6,322214.71875,2317.2382616149102
49108,11226,11226,36047080200,185243,0,Census Tract 802,New York,Kings County,2318,4096,2739,2537,0,2223,95,219,202,148,0,111,37,54,1357,996,0,908,88,361,634,15.5,8.6,26.7,26.6,322214.71875,2317.2382616149102
49109,11225,11225,36047080400,189757,0,Census Tract 804,New York,Kings County,1416,2769,1789,1670,0,1321,95,254,119,93,0,93,0,26,980,760,0,611,149,220,500,18.1,15.2,21.8,22.4,330077.203125,2690.1968881680605
49109,11226,11226,36047080400,189757,0,Census Tract 804,New York,Kings County,1416,2769,1789,1670,0,1321,95,254,119,93,0,93,0,26,980,760,0,611,149,220,500,18.1,15.2,21.8,22.4,330077.203125,2690.1968881680605
49110,11203,11203,36047080600,166299,0,Census Tract 806,New York,Kings County,1634,2692,1905,1750,0,1566,68,116,155,155,0,155,0,0,787,679,0,638,41,108,224,8.3,6.6,0.0,13.7,289295.23828125,2417.13471882088
49110,11225,11225,36047080600,166299,0,Census Tract 806,New York,Kings County,1634,2692,1905,1750,0,1566,68,116,155,155,0,155,0,0,787,679,0,638,41,108,224,8.3,6.6,0.0,13.7,289295.23828125,2417.13471882088
49111,11203,11203,36047080800,321836,0,Census Tract 808,New York,Kings County,105,487,143,110,0,87,18,5,33,21,0,12,9,12,344,106,0,61,45,238,255,52.4,4.5,36.4,69.2,559797.3828125,4818.289939180921
49112,11203,11203,36047081000,162414,0,Census Tract 810,New York,Kings County,976,1765,1105,1011,0,889,87,35,94,85,0,81,4,9,660,518,0,458,60,142,186,10.5,3.5,9.6,21.5,282517.7890625,2640.89651333532
49113,11203,11203,36047081400,170174,0,Census Tract 814,New York,Kings County,1172,2259,1350,1245,0,1083,89,73,105,105,0,105,0,0,909,825,0,718,107,84,157,6.9,5.9,0.0,9.2,295968.9375,2243.73967900746
49114,11203,11203,36047081600,179640,0,Census Tract 816,New York,Kings County,1020,1945,1322,1259,0,932,88,239,63,63,0,56,7,0,623,495,0,469,26,128,367,18.9,19.0,0.0,20.5,312429.20703125,2445.0594145299397
49115,11203,11203,36047081800,157918,0,Census Tract 818,New York,Kings County,2175,3786,2474,2359,0,1896,279,184,115,115,0,28,87,0,1312,1023,0,965,58,289,473,12.5,7.8,0.0,22.0,274645.0546875,2229.17530233807
49115,11226,11226,36047081800,157918,0,Census Tract 818,New York,Kings County,2175,3786,2474,2359,0,1896,279,184,115,115,0,28,87,0,1312,1023,0,965,58,289,473,12.5,7.8,0.0,22.0,274645.0546875,2229.17530233807
49116,11226,11226,36047082000,148600,0,Census Tract 820,New York,Kings County,1833,4004,2491,2215,9,1674,150,382,276,227,0,193,34,49,1513,1203,0,982,221,310,741,18.5,17.2,17.8,20.5,258442.65234375,2245.17692732283
49117,11226,11226,36047082200,169861,0,Census Tract 822,New York,Kings County,3056,5776,3852,3525,0,2366,690,469,327,261,0,131,130,66,1924,1414,0,973,441,510,1045,18.1,13.3,20.2,26.5,295418.125,2330.54576585684
49118,11203,11203,36047082400,214344,0,Census Tract 824,New York,Kings County,1905,3466,2203,2053,0,1863,42,148,150,131,0,131,0,19,1263,929,10,852,67,334,501,14.5,7.2,12.7,26.4,372730.83203125,2446.02460993043
49118,11226,11226,36047082400,214344,0,Census Tract 824,New York,Kings County,1905,3466,2203,2053,0,1863,42,148,150,131,0,131,0,19,1263,929,10,852,67,334,501,14.5,7.2,12.7,26.4,372730.83203125,2446.02460993043
49119,11203,11203,36047082600,199092,0,Census Tract 826,New York,Kings County,2265,4375,2724,2476,0,1994,271,211,248,213,0,213,0,35,1651,1157,0,1100,57,494,740,16.9,8.5,14.1,29.9,346171.56640625,2364.06012704925
49119,11226,11226,36047082600,199092,0,Census Tract 826,New York,Kings County,2265,4375,2724,2476,0,1994,271,211,248,213,0,213,0,35,1651,1157,0,1100,57,494,740,16.9,8.5,14.1,29.9,346171.56640625,2364.06012704925
49120,11210,11210,36047082800,156676,0,Census Tract 828,New York,Kings County,1669,3078,2088,1918,0,1578,91,249,170,137,0,127,10,33,990,841,0,764,77,149,431,14.0,13.0,19.4,15.1,272387.0546875,2228.0507913238503
49120,11226,11226,36047082800,156676,0,Census Tract 828,New York,Kings County,1669,3078,2088,1918,0,1578,91,249,170,137,0,127,10,33,990,841,0,764,77,149,431,14.0,13.0,19.4,15.1,272387.0546875,2228.0507913238503
49121,11203,11203,36047083000,201784,0,Census Tract 830,New York,Kings County,2882,4853,3263,3136,0,2812,70,254,127,107,0,107,0,20,1590,1417,0,1369,48,173,447,9.2,8.1,15.7,10.9,350811.94140625,2652.7687793866103
49121,11210,11210,36047083000,201784,0,Census Tract 830,New York,Kings County,2882,4853,3263,3136,0,2812,70,254,127,107,0,107,0,20,1590,1417,0,1369,48,173,447,9.2,8.1,15.7,10.9,350811.94140625,2652.7687793866103
49121,11226,11226,36047083000,201784,0,Census Tract 830,New York,Kings County,2882,4853,3263,3136,0,2812,70,254,127,107,0,107,0,20,1590,1417,0,1369,48,173,447,9.2,8.1,15.7,10.9,350811.94140625,2652.7687793866103
49122,11203,11203,36047083200,145549,0,Census Tract 832,New York,Kings County,876,1708,1014,951,0,866,10,75,63,63,0,63,0,0,694,613,22,580,11,81,156,9.1,7.9,0.0,11.7,253046.6171875,2215.8618919615697
49123,11203,11203,36047083400,125994,0,Census Tract 834,New York,Kings County,671,1274,778,715,0,656,15,44,63,50,0,27,23,13,496,410,0,381,29,86,143,11.2,6.2,20.6,17.3,219051.61328125,2007.2793372686801
49124,11203,11203,36047083600,208197,0,Census Tract 836,New York,Kings County,981,1759,1183,1073,15,931,35,92,110,110,0,103,7,0,576,476,0,454,22,100,192,10.9,8.6,0.0,17.4,361920.125,2422.4224871404
49124,11210,11210,36047083600,208197,0,Census Tract 836,New York,Kings County,981,1759,1183,1073,15,931,35,92,110,110,0,103,7,0,576,476,0,454,22,100,192,10.9,8.6,0.0,17.4,361920.125,2422.4224871404
49125,11203,11203,36047083800,166942,0,Census Tract 838,New York,Kings County,1110,1950,1177,1149,0,1083,27,39,28,28,0,24,4,0,773,596,25,553,18,177,216,11.1,3.4,0.0,22.9,290243.50390625,2215.64651745057
49126,11203,11203,36047084000,170057,0,Census Tract 840,New York,Kings County,1104,1999,1192,1161,0,992,112,57,31,31,0,31,0,0,807,679,0,636,43,128,185,9.3,4.9,0.0,15.9,295660.32421875,2231.5096922572698
49127,11203,11203,36047084600,166530,0,Census Tract 846,New York,Kings County,782,1519,869,836,0,744,38,54,33,33,0,33,0,0,650,563,12,542,9,87,141,9.3,6.5,0.0,13.4,289528.8203125,2179.7196608044896
49128,11203,11203,36047084800,137501,0,Census Tract 848,New York,Kings County,752,1433,886,819,0,716,36,67,67,60,0,60,0,7,547,489,0,459,30,58,132,9.2,8.2,10.4,10.6,239092.890625,1969.4523271852104
49129,11203,11203,36047085000,144613,0,Census Tract 850,New York,Kings County,667,1182,780,706,0,554,113,39,74,60,0,43,17,14,402,344,0,322,22,58,111,9.4,5.5,18.9,14.4,251450.76953125,2815.3077797081105
49130,11203,11203,36047085200,395710,0,Census Tract 852,New York,Kings County,0,0,0,0,0,0,0,0,0,0,0,0,0,0,0,0,0,0,0,0,0,,,,,688081.234375,3680.7619427615996
49131,11203,11203,36047085400,128750,0,Census Tract 854,New York,Kings County,870,1569,983,950,0,854,16,80,33,33,0,28,5,0,586,416,0,404,12,170,250,15.9,8.4,0.0,29.0,223861.50390625,2942.46477927837
49132,11203,11203,36047085600,158646,0,Census Tract 856,New York,Kings County,1542,2968,1974,1854,0,1478,64,312,120,120,0,120,0,0,994,773,24,721,28,221,533,18.0,16.8,0.0,22.2,275875.09375,2516.67259798171
49133,11203,11203,36047085800,138512,0,Census Tract 858,New York,Kings County,1019,1962,1170,1125,0,1005,14,106,45,38,0,32,6,7,792,677,0,614,63,115,228,11.6,9.4,15.6,14.5,240875.46875,2292.22809434554
49134,11203,11203,36047086000,175366,0,Census Tract 860,New York,Kings County,1561,2713,1809,1739,30,1474,57,178,70,70,0,70,0,0,904,695,0,657,38,209,387,14.3,10.2,0.0,23.1,304964.09765625,2337.71881919963
49135,11203,11203,36047086200,140147,0,Census Tract 862,New York,Kings County,1161,2259,1420,1362,0,1043,118,201,58,42,0,16,26,16,839,574,0,467,107,265,482,21.3,14.8,27.6,31.6,243719.83984375,1980.1449722879602
49136,11203,11203,36047086400,150824,0,Census Tract 864,New York,Kings County,1013,1911,1150,1086,0,982,31,73,64,49,0,42,7,15,761,599,0,517,82,162,250,13.1,6.7,23.4,21.3,262319.75390625,2166.83369231619
49136,11212,11212,36047086400,150824,0,Census Tract 864,New York,Kings County,1013,1911,1150,1086,0,982,31,73,64,49,0,42,7,15,761,599,0,517,82,162,250,13.1,6.7,23.4,21.3,262319.75390625,2166.83369231619
49137,11203,11203,36047086600,156523,0,Census Tract 866,New York,Kings County,1415,2460,1562,1487,0,1241,174,72,75,75,0,75,0,0,898,674,0,588,86,224,296,12.0,4.8,0.0,24.9,272246.87109375,3025.0516772560304
49137,11212,11212,36047086600,156523,0,Census Tract 866,New York,Kings County,1415,2460,1562,1487,0,1241,174,72,75,75,0,75,0,0,898,674,0,588,86,224,296,12.0,4.8,0.0,24.9,272246.87109375,3025.0516772560304
49138,11203,11203,36047086800,174581,0,Census Tract 868,New York,Kings County,1315,2565,1610,1527,0,1266,49,212,83,65,0,65,0,18,955,681,0,671,10,274,504,19.6,13.9,21.7,28.7,303634.82421875,2254.56171925513
49139,11203,11203,36047087000,155718,0,Census Tract 870,New York,Kings County,1233,2480,1473,1352,0,1082,151,119,121,109,0,87,22,12,1007,683,0,624,59,324,455,18.3,8.8,9.9,32.2,270828.31640625,2270.42361069503
49140,11203,11203,36047087200,147204,0,Census Tract 872,New York,Kings County,1269,2166,1445,1363,0,1205,64,94,82,73,0,73,0,9,721,512,0,432,80,209,312,14.4,6.9,11.0,29.0,256017.546875,2255.92478699618
49141,11203,11203,36047087401,130596,0,Census Tract 874.01,New York,Kings County,1109,2678,1570,1327,98,988,23,218,243,212,0,212,0,31,1108,697,0,638,59,411,660,24.6,16.4,12.8,37.1,227176.64453125,2164.58790824065
49142,11203,11203,36047087600,142213,0,Census Tract 876,New York,Kings County,684,1386,780,752,0,649,35,68,28,28,0,13,15,0,606,456,0,433,23,150,218,15.7,9.0,0.0,24.8,247387.53515625,2170.5151046451897
49143,11203,11203,36047087800,151414,0,Census Tract 878,New York,Kings County,915,1723,1112,1021,4,865,46,106,91,65,0,65,0,26,611,402,5,307,90,209,341,19.8,10.4,28.6,34.2,263381.19140625,2470.7775697019
49144,11203,11203,36047088000,182479,0,Census Tract 880,New York,Kings County,1245,2179,1363,1299,0,1216,29,54,64,64,0,64,0,0,816,662,0,609,53,154,208,9.5,4.2,0.0,18.9,317439.8046875,3114.1823396025397
49144,11212,11212,36047088000,182479,0,Census Tract 880,New York,Kings County,1245,2179,1363,1299,0,1216,29,54,64,64,0,64,0,0,816,662,0,609,53,154,208,9.5,4.2,0.0,18.9,317439.8046875,3114.1823396025397
49145,11212,11212,36047088200,203180,0,Census Tract 882,New York,Kings County,3045,4994,3347,3158,0,3002,43,113,189,189,0,189,0,0,1647,1253,0,1199,54,394,507,10.2,3.6,0.0,23.9,353440.84765625,3511.9260562944
49146,11212,11212,36047088400,167059,0,Census Tract 884,New York,Kings County,1872,3669,2270,2016,36,1656,180,144,254,254,0,254,0,0,1399,1097,0,978,119,302,446,12.2,7.1,0.0,21.6,290623.921875,2611.14312901184
49147,11212,11212,36047088600,179724,0,Census Tract 886,New York,Kings County,1710,3517,2210,1778,0,1582,128,68,432,410,0,293,117,22,1307,1037,0,928,109,270,360,10.2,3.8,5.1,20.7,312612.90625,2571.5645197509803
49148,11212,11212,36047088800,201249,0,Census Tract 888,New York,Kings County,1779,3420,2128,1985,0,1650,129,206,143,122,0,111,11,21,1292,1099,0,972,127,193,420,12.3,10.4,14.7,14.9,350015.203125,2610.21263629335
49148,11236,11236,36047088800,201249,0,Census Tract 888,New York,Kings County,1779,3420,2128,1985,0,1650,129,206,143,122,0,111,11,21,1292,1099,0,972,127,193,420,12.3,10.4,14.7,14.9,350015.203125,2610.21263629335
49149,11212,11212,36047089000,248416,0,Census Tract 890,New York,Kings County,2284,4011,2758,2473,0,1910,374,189,285,242,0,152,90,43,1253,918,0,791,127,335,567,14.1,7.6,15.1,26.7,432087.86328125,3797.5526811077
49150,11212,11212,36047089200,179663,0,Census Tract 892,New York,Kings County,1126,2655,1385,1189,0,963,163,63,196,151,0,139,12,45,1270,829,0,657,172,441,549,20.7,5.3,23.0,34.7,312560.453125,3096.52449780489
49151,11212,11212,36047089400,172215,0,Census Tract 894,New York,Kings County,872,2015,1163,973,0,769,103,101,190,176,0,110,66,14,852,748,0,616,132,104,219,10.9,10.4,7.4,12.2,299585.07421875,2530.63493096708
49152,11212,11212,36047089600,149024,0,Census Tract 896,New York,Kings County,1199,2720,1704,1399,0,1104,95,200,305,234,0,234,0,71,1016,768,0,607,161,248,519,19.1,14.3,23.3,24.4,259216.1953125,2267.2659180895103
49153,11212,11212,36047089800,154357,0,Census Tract 898,New York,Kings County,611,1319,751,645,0,590,21,34,106,86,0,86,0,20,568,425,0,367,58,143,197,14.9,5.3,18.9,25.2,268532.17578125,2230.9953478883103
49154,11212,11212,36047090000,246239,0,Census Tract 900,New York,Kings County,1547,3413,1853,1615,0,1216,331,68,238,238,0,198,40,0,1560,1132,0,866,266,428,496,14.5,4.2,0.0,27.4,428419.828125,2713.11761603768
49155,11212,11212,36047090200,190560,0,Census Tract 902,New York,Kings County,777,1659,918,827,0,761,16,50,91,91,0,76,15,0,741,564,0,488,76,177,227,13.7,6.0,0.0,23.9,331556.36328125,2428.16044315665
49156,11212,11212,36047090600,195831,0,Census Tract 906,New York,Kings County,710,2551,1201,891,0,551,159,181,310,304,0,291,13,6,1350,1025,0,749,276,325,512,20.1,20.3,1.9,24.1,340757.05859375,2478.76052446957
49157,11212,11212,36047090800,296447,0,Census Tract 908,New York,Kings County,387,2093,658,459,0,338,49,72,199,199,0,199,0,0,1435,1164,0,1010,154,271,343,16.4,15.7,0.0,18.9,515850.35546875,3035.9227646636896
49158,11212,11212,36047091000,212068,0,Census Tract 910,New York,Kings County,589,3472,1246,890,0,552,37,301,356,292,0,292,0,64,2226,1113,0,785,328,1113,1478,42.6,33.8,18.0,50.0,368959.6953125,2449.92610619013
49159,11212,11212,36047091200,167237,0,Census Tract 912,New York,Kings County,1093,4351,1799,1356,0,1018,75,263,443,443,0,432,11,0,2552,1811,0,1603,208,741,1004,23.1,19.4,0.0,29.0,290958.97265625,2224.1723308456
49160,11212,11212,36047091600,215640,0,Census Tract 916,New York,Kings County,1131,2917,1391,1184,0,996,135,53,207,134,0,134,0,73,1526,1228,0,902,326,298,424,14.5,4.5,35.3,19.5,375104.5703125,2729.50851764522
49161,11212,11212,36047091800,209632,0,Census Tract 918,New York,Kings County,831,1801,1100,871,0,775,56,40,229,229,0,212,17,0,701,564,0,433,131,137,177,9.8,4.6,0.0,19.5,364680.26953125,2613.7107951255102
49162,11212,11212,36047092000,237149,0,Census Tract 920,New York,Kings County,803,2105,1021,845,0,674,129,42,176,138,0,138,0,38,1084,875,0,736,139,209,289,13.7,5.0,21.6,19.3,412510.0703125,2688.47554110887
49163,11212,11212,36047092200,161392,0,Census Tract 922,New York,Kings County,970,2159,1196,1005,0,938,32,35,191,191,0,161,30,0,963,710,0,637,73,253,288,13.3,3.5,0.0,26.3,280708.6171875,3097.7825260244
49163,11236,11236,36047092200,161392,0,Census Tract 922,New York,Kings County,970,2159,1196,1005,0,938,32,35,191,191,0,161,30,0,963,710,0,637,73,253,288,13.3,3.5,0.0,26.3,280708.6171875,3097.7825260244
49164,11212,11212,36047092400,251687,0,Census Tract 924,New York,Kings County,1028,1936,1154,1098,0,804,224,70,56,56,0,56,0,0,782,683,0,610,73,99,169,8.7,6.4,0.0,12.7,437908.41015625,3400.4097596031397
49165,11236,11236,36047092800,157219,0,Census Tract 928,New York,Kings County,1439,2708,1684,1611,0,1326,113,172,73,63,0,63,0,10,1024,778,0,643,135,246,428,15.8,10.7,13.7,24.0,273425.0625,2143.3739270351502
49166,11236,11236,36047093000,194229,0,Census Tract 930,New York,Kings County,1320,2524,1640,1508,7,1211,102,188,132,106,0,86,20,26,884,793,0,767,26,91,305,12.1,12.5,19.7,10.3,337764.390625,2667.3686806514997
49167,11203,11203,36047093200,280436,0,Census Tract 932,New York,Kings County,554,1092,665,585,0,515,39,31,80,64,0,64,0,16,427,363,0,336,27,64,111,10.2,5.3,20.0,15.0,487496.31640625,2784.31338647427
49167,11234,11234,36047093200,280436,0,Census Tract 932,New York,Kings County,554,1092,665,585,0,515,39,31,80,64,0,64,0,16,427,363,0,336,27,64,111,10.2,5.3,20.0,15.0,487496.31640625,2784.31338647427
49168,11236,11236,36047093400,177759,0,Census Tract 934,New York,Kings County,1255,2040,1380,1301,0,1229,26,46,79,79,0,53,26,0,660,500,0,451,49,160,206,10.1,3.5,0.0,24.2,309115.6015625,2916.4329745800396
49169,11203,11203,36047093600,165120,0,Census Tract 936,New York,Kings County,804,1442,837,824,0,773,31,20,13,13,0,13,0,0,605,555,0,532,23,50,70,4.9,2.4,0.0,8.3,287136.0078125,3015.8287154894106
49169,11236,11236,36047093600,165120,0,Census Tract 936,New York,Kings County,804,1442,837,824,0,773,31,20,13,13,0,13,0,0,605,555,0,532,23,50,70,4.9,2.4,0.0,8.3,287136.0078125,3015.8287154894106
49170,11203,11203,36047093800,131105,0,Census Tract 938,New York,Kings County,1140,1992,1322,1226,0,1115,25,86,96,55,0,55,0,41,670,512,0,451,61,158,285,14.3,7.0,42.7,23.6,227996.34375,2122.79021202612
49171,11203,11203,36047094401,368964,0,Census Tract 944.01,New York,Kings County,1734,3362,2214,2008,20,1538,176,274,206,191,0,156,35,15,1148,1110,37,1035,38,38,327,9.7,13.6,7.3,3.3,641417.05078125,4036.6761696269896
49171,11234,11234,36047094401,368964,0,Census Tract 944.01,New York,Kings County,1734,3362,2214,2008,20,1538,176,274,206,191,0,156,35,15,1148,1110,37,1035,38,38,327,9.7,13.6,7.3,3.3,641417.05078125,4036.6761696269896
49171,11236,11236,36047094401,368964,0,Census Tract 944.01,New York,Kings County,1734,3362,2214,2008,20,1538,176,274,206,191,0,156,35,15,1148,1110,37,1035,38,38,327,9.7,13.6,7.3,3.3,641417.05078125,4036.6761696269896
49172,11234,11234,36047094402,106850,0,Census Tract 944.02,New York,Kings County,892,2227,1233,1036,0,816,76,144,197,197,0,177,20,0,994,712,0,540,172,282,426,19.1,13.9,0.0,28.4,185731.56640625,1756.82440673202
49173,11203,11203,36047094600,281769,0,Census Tract 946,New York,Kings County,843,1529,940,868,0,802,41,25,72,72,0,72,0,0,589,491,0,485,6,98,123,8.0,2.9,0.0,16.6,489922.52734375,3590.3917878475895
49173,11236,11236,36047094600,281769,0,Census Tract 946,New York,Kings County,843,1529,940,868,0,802,41,25,72,72,0,72,0,0,589,491,0,485,6,98,123,8.0,2.9,0.0,16.6,489922.52734375,3590.3917878475895
49174,11236,11236,36047095000,242443,0,Census Tract 950,New York,Kings County,1265,2382,1573,1482,0,1221,44,217,91,86,0,86,0,5,809,633,0,625,8,176,398,16.7,14.6,5.5,21.8,421441.046875,3200.66442153914
49175,11236,11236,36047095400,237026,0,Census Tract 954,New York,Kings County,2130,3476,2276,2172,24,2072,34,42,104,104,0,104,0,0,1200,944,21,896,27,256,298,8.6,1.9,0.0,21.3,412055.56640625,2785.8922057302098
49176,11236,11236,36047095600,237582,0,Census Tract 956,New York,Kings County,2260,3507,2441,2347,0,2192,68,87,94,94,0,83,11,0,1066,923,0,883,40,143,230,6.6,3.7,0.0,13.4,412980.96875,3218.35787555016
49177,11236,11236,36047095800,234373,0,Census Tract 958,New York,Kings County,1718,3175,1915,1849,0,1659,59,131,66,58,0,58,0,8,1260,1001,0,935,66,259,398,12.5,7.1,12.1,20.6,407470.45703125,2753.60897967455
49178,11236,11236,36047096000,423887,0,Census Tract 960,New York,Kings County,0,0,0,0,0,0,0,0,0,0,0,0,0,0,0,0,0,0,0,0,0,,,,,737054.4453125,4454.20579255254
49179,11236,11236,36047096200,179100,0,Census Tract 962,New York,Kings County,863,1339,969,921,0,813,50,58,48,37,0,27,10,11,370,331,0,303,28,39,108,8.1,6.3,22.9,10.5,311409.17578125,2198.5612224830998
49180,11236,11236,36047096400,176581,0,Census Tract 964,New York,Kings County,931,1553,1012,980,0,778,153,49,32,24,0,17,7,8,541,491,0,456,35,50,107,6.9,5.0,25.0,9.2,307006.39453125,2217.2422297444
49181,11236,11236,36047096600,181211,0,Census Tract 966,New York,Kings County,1301,2152,1454,1398,0,1234,67,97,56,56,0,56,0,0,698,590,0,520,70,108,205,9.5,6.9,0.0,15.5,315040.3125,2619.27720727622
49182,11236,11236,36047096800,149019,0,Census Tract 968,New York,Kings County,628,1200,717,672,0,552,76,44,45,37,0,28,9,8,483,466,0,413,53,17,69,5.8,6.5,17.8,3.5,259102.5625,2049.20837843413
49183,11236,11236,36047097000,163450,0,Census Tract 970,New York,Kings County,1244,2247,1573,1422,0,1171,73,178,151,109,0,109,0,42,674,603,0,557,46,71,291,13.0,12.5,27.8,10.5,284219.5859375,2161.5830188712
49184,11236,11236,36047097400,252349,0,Census Tract 974,New York,Kings County,1015,1651,1101,1025,0,954,61,10,76,76,0,76,0,0,550,503,0,497,6,47,57,3.5,1.0,0.0,8.5,438801.53125,2897.8105197827003
49185,11207,11207,36047098200,345649,0,Census Tract 982,New York,Kings County,1168,3122,1573,1343,0,1020,148,175,230,177,0,130,47,53,1549,1123,0,934,189,426,654,20.9,13.0,23.0,27.5,601105.3984375,3595.09845897865
49185,11236,11236,36047098200,345649,0,Census Tract 982,New York,Kings County,1168,3122,1573,1343,0,1020,148,175,230,177,0,130,47,53,1549,1123,0,934,189,426,654,20.9,13.0,23.0,27.5,601105.3984375,3595.09845897865
49186,11236,11236,36047098400,112821,0,Census Tract 984,New York,Kings County,1114,1715,1199,1149,0,1071,43,35,50,50,0,50,0,0,516,469,0,450,19,47,82,4.8,3.0,0.0,9.1,196175.84765625,1884.0488088156
49187,11236,11236,36047098600,155971,0,Census Tract 986,New York,Kings County,1461,2447,1625,1503,0,1401,60,42,122,122,0,117,5,0,822,727,0,688,39,95,137,5.6,2.8,0.0,11.6,271192.8984375,2122.11364989085
49188,11236,11236,36047098800,161941,0,Census Tract 988,New York,Kings County,1386,2238,1577,1464,0,1353,33,78,113,84,0,81,3,29,661,545,0,498,47,116,223,10.0,5.3,25.7,17.5,281557.7265625,2154.02434050496
49189,11236,11236,36047099000,163721,0,Census Tract 990,New York,Kings County,830,1289,888,830,0,812,18,0,58,58,0,58,0,0,401,318,0,318,0,83,83,6.4,0.0,0.0,20.7,284624.875,2161.87480969853
49190,11236,11236,36047099200,134602,0,Census Tract 992,New York,Kings County,1132,1792,1241,1145,0,1087,45,13,96,96,0,90,6,0,551,527,0,481,46,24,37,2.1,1.1,0.0,4.4,233988.16796875,2114.9689068346397
49191,11236,11236,36047099400,173970,0,Census Tract 994,New York,Kings County,942,1543,1019,980,0,916,26,38,39,39,0,39,0,0,524,475,0,440,35,49,87,5.6,3.9,0.0,9.4,302407.76171875,2316.19288876249
49192,11236,11236,36047099600,189693,0,Census Tract 996,New York,Kings County,1775,2972,1962,1827,0,1710,65,52,135,135,0,135,0,0,1010,881,0,881,0,129,181,6.1,2.8,0.0,12.8,329713.2890625,2276.86790124621
49193,11236,11236,36047099800,419733,69968,Census Tract 998,New York,Kings County,1739,2883,1945,1866,0,1610,129,127,79,79,0,68,11,0,938,809,0,704,105,129,256,8.9,6.8,0.0,13.8,729485.7734375,5268.0540644740395
49194,11236,11236,36047100400,132054,0,Census Tract 1004,New York,Kings County,1306,2072,1371,1340,0,1179,127,34,31,31,0,31,0,0,701,642,0,525,117,59,93,4.5,2.5,0.0,8.4,229512.2421875,2007.0689080052
49195,11236,11236,36047100600,152116,0,Census Tract 1006,New York,Kings County,1226,1939,1389,1265,5,1182,39,39,124,124,0,101,23,0,550,488,0,472,16,62,101,5.2,3.1,0.0,11.3,264392.03125,2097.69594490719
49196,11236,11236,36047100800,148898,0,Census Tract 1008,New York,Kings County,960,1641,1066,973,0,850,110,13,93,87,0,87,0,6,575,543,0,459,84,32,51,3.1,1.3,6.5,5.6,258813.859375,2182.7472456192604
49197,11236,11236,36047101000,171343,0,Census Tract 1010,New York,Kings County,1157,1850,1172,1157,0,1083,74,0,15,15,0,15,0,0,678,614,0,591,23,64,64,3.5,0.0,0.0,9.4,297844.33203125,2252.6313982986603
49198,11236,11236,36047101200,160761,0,Census Tract 1012,New York,Kings County,1070,1855,1150,1106,0,969,101,36,44,44,0,44,0,0,705,598,0,525,73,107,143,7.7,3.3,0.0,15.2,279477.62109375,2145.44207814631
49199,11236,11236,36047101400,154954,0,Census Tract 1014,New York,Kings County,1096,1834,1196,1135,0,1069,27,39,61,61,0,61,0,0,638,593,0,580,13,45,84,4.6,3.4,0.0,7.1,269398.80859375,2113.83216494492
49200,11236,11236,36047101600,112418,0,Census Tract 1016,New York,Kings County,838,1438,937,865,0,810,28,27,72,72,0,53,19,0,501,427,0,419,8,74,101,7.0,3.1,0.0,14.8,195456.9921875,1878.88596555875
49201,11236,11236,36047101800,283765,0,Census Tract 1018,New York,Kings County,1199,1990,1313,1199,0,1087,112,0,114,114,0,114,0,0,677,624,0,602,22,53,53,2.7,0.0,0.0,7.8,489574.11328125,4756.70031145818
49202,11236,11236,36047102000,157042,0,Census Tract 1020,New York,Kings County,1047,1736,1153,1047,0,1014,33,0,106,106,0,106,0,0,583,523,0,523,0,60,60,3.5,0.0,0.0,10.3,273001.87890625,2127.8116107140804
49203,11236,11236,36047102200,162849,0,Census Tract 1022,New York,Kings County,1070,1677,1123,1102,21,1044,5,32,21,21,0,21,0,0,554,428,4,424,0,126,158,9.4,2.9,0.0,22.7,283080.48046875,2161.55490286581
49204,11236,11236,36047102400,143125,0,Census Tract 1024,New York,Kings County,1041,1817,1210,1122,0,1007,34,81,88,70,0,58,12,18,607,524,0,492,32,83,182,10.0,7.2,20.5,13.7,248770.21875,2190.97734088613
49205,11236,11236,36047102600,135920,0,Census Tract 1026,New York,Kings County,1576,2311,1640,1604,0,1466,110,28,36,36,0,29,7,0,671,637,0,580,57,34,62,2.7,1.7,0.0,5.1,236221.56640625,2153.63732662873
49206,11236,11236,36047102800,1018887,217164,Census Tract 1028,New York,Kings County,912,1397,1042,968,0,857,55,56,74,74,0,64,10,0,355,347,0,334,13,8,64,4.6,5.8,0.0,2.3,1770688.88671875,5461.07381349202
49207,11236,11236,36047103400,666213,222181,Census Tract 1034,New York,Kings County,1243,2920,1505,1360,28,1159,56,117,145,136,0,120,16,9,1415,986,0,933,53,429,555,19.0,8.6,6.2,30.3,1155025.0703125,5002.95387842057
49208,11239,11239,36047105801,418442,0,Census Tract 1058.01,New York,Kings County,1966,4720,2342,2238,0,1908,58,272,104,104,0,104,0,0,2378,1377,14,1201,162,1001,1273,27.0,12.2,0.0,42.1,727655.0859375,4232.16048323133
49209,11239,11239,36047105804,770253,27109,Census Tract 1058.04,New York,Kings County,2354,5845,2791,2473,13,2128,213,119,318,318,0,301,17,0,3054,2170,26,1769,375,884,1003,17.2,4.8,0.0,28.9,1339321.77734375,5726.54560064323
49210,11207,11207,36047107000,3457775,541213,Census Tract 1070,New York,Kings County,1005,1537,1131,1012,0,895,110,7,119,119,0,100,19,0,406,393,0,355,38,13,20,1.3,0.7,0.0,3.2,5209011.82421875,14676.0263261783
49210,11208,11208,36047107000,3457775,541213,Census Tract 1070,New York,Kings County,1005,1537,1131,1012,0,895,110,7,119,119,0,100,19,0,406,393,0,355,38,13,20,1.3,0.7,0.0,3.2,5209011.82421875,14676.0263261783
49210,11239,11239,36047107000,3457775,541213,Census Tract 1070,New York,Kings County,1005,1537,1131,1012,0,895,110,7,119,119,0,100,19,0,406,393,0,355,38,13,20,1.3,0.7,0.0,3.2,5209011.82421875,14676.0263261783
49211,11207,11207,36047107800,506529,0,Census Tract 1078,New York,Kings County,2090,3549,2324,2241,0,1763,327,151,83,83,0,83,0,0,1225,1048,0,951,97,177,328,9.2,6.7,0.0,14.4,881093.41015625,5392.58688204108
49211,11208,11208,36047107800,506529,0,Census Tract 1078,New York,Kings County,2090,3549,2324,2241,0,1763,327,151,83,83,0,83,0,0,1225,1048,0,951,97,177,328,9.2,6.7,0.0,14.4,881093.41015625,5392.58688204108
49211,11239,11239,36047107800,506529,0,Census Tract 1078,New York,Kings County,2090,3549,2324,2241,0,1763,327,151,83,83,0,83,0,0,1225,1048,0,951,97,177,328,9.2,6.7,0.0,14.4,881093.41015625,5392.58688204108
49212,11207,11207,36047109800,854379,0,Census Tract 1098,New York,Kings County,951,1488,1048,1001,0,771,180,50,47,41,0,29,12,6,440,359,0,335,24,81,137,9.2,5.0,12.8,18.4,1485893.8984375,5452.73610289779
49212,11236,11236,36047109800,854379,0,Census Tract 1098,New York,Kings County,951,1488,1048,1001,0,771,180,50,47,41,0,29,12,6,440,359,0,335,24,81,137,9.2,5.0,12.8,18.4,1485893.8984375,5452.73610289779
49213,11207,11207,36047110400,742524,0,Census Tract 1104,New York,Kings County,1510,3511,1859,1539,0,1318,192,29,320,292,0,292,0,28,1652,1477,0,1208,269,175,232,6.6,1.9,8.8,10.6,1291536.515625,6022.377330333659
49214,11207,11207,36047110600,171053,0,Census Tract 1106,New York,Kings County,1066,3055,1410,1246,0,996,70,180,164,142,0,116,26,22,1645,1199,0,1149,50,446,648,21.2,14.4,13.4,27.1,297527.3125,2201.33319511974
49215,11207,11207,36047111000,124983,0,Census Tract 1110,New York,Kings County,931,2484,1264,1022,0,765,166,91,242,242,0,195,47,0,1220,795,0,632,163,425,516,20.8,8.9,0.0,34.8,217413.375,1880.80888576351
49216,11207,11207,36047111600,499699,0,Census Tract 1116,New York,Kings County,1414,2622,1602,1446,0,1304,110,32,156,127,0,127,0,29,1020,1010,0,834,176,10,71,2.7,2.2,18.6,1.0,869339.44140625,3818.5762842539502
49216,11208,11208,36047111600,499699,0,Census Tract 1116,New York,Kings County,1414,2622,1602,1446,0,1304,110,32,156,127,0,127,0,29,1020,1010,0,834,176,10,71,2.7,2.2,18.6,1.0,869339.44140625,3818.5762842539502
49217,11208,11208,36047111800,162309,0,Census Tract 1118,New York,Kings County,1067,2502,1213,1117,0,1067,0,50,96,96,0,96,0,0,1289,1106,0,991,115,183,233,9.3,4.5,0.0,14.2,282413.4765625,2124.05034091955
49218,11207,11207,36047112000,173003,0,Census Tract 1120,New York,Kings County,1218,2497,1378,1242,0,1105,113,24,136,123,0,123,0,13,1119,1059,0,727,332,60,97,3.9,1.9,9.6,5.4,301007.7890625,2208.34400811265
49218,11208,11208,36047112000,173003,0,Census Tract 1120,New York,Kings County,1218,2497,1378,1242,0,1105,113,24,136,123,0,123,0,13,1119,1059,0,727,332,60,97,3.9,1.9,9.6,5.4,301007.7890625,2208.34400811265
49219,11207,11207,36047112200,162285,0,Census Tract 1122,New York,Kings County,1271,2624,1564,1393,0,1099,172,122,171,158,0,139,19,13,1060,914,0,658,256,146,281,10.7,8.8,7.6,13.8,282327.60546875,2383.3029307800603
49220,11207,11207,36047112400,177849,0,Census Tract 1124,New York,Kings County,1641,2544,1755,1641,0,1486,155,0,114,114,0,114,0,0,789,769,0,624,145,20,20,0.8,0.0,0.0,2.5,309428.3046875,2360.92361980728
49221,11207,11207,36047112600,168500,0,Census Tract 1126,New York,Kings County,1199,2786,1549,1355,68,989,142,156,194,148,0,117,31,46,1237,1048,35,562,451,189,391,14.0,11.5,23.7,15.3,293152.69921875,2194.62307954491
49222,11207,11207,36047112800,184193,0,Census Tract 1128,New York,Kings County,1611,3170,1905,1696,0,1477,134,85,209,209,0,165,44,0,1265,1123,0,863,260,142,227,7.2,5.0,0.0,11.2,320424.67578125,2308.1306058271302
49223,11207,11207,36047113000,193832,0,Census Tract 1130,New York,Kings County,1652,3069,1880,1700,0,1600,52,48,180,180,0,166,14,0,1189,992,0,878,114,197,245,8.0,2.8,0.0,16.6,337198.93359375,3054.0331496002505
49224,11207,11207,36047113200,196193,0,Census Tract 1132,New York,Kings County,937,1569,1010,965,7,880,50,28,45,45,0,45,0,0,559,547,7,453,87,12,40,2.5,2.9,0.0,2.1,341295.328125,3226.18657100031
49225,11207,11207,36047113400,153420,0,Census Tract 1134,New York,Kings County,788,1789,948,832,0,736,52,44,116,116,0,98,18,0,841,751,0,555,196,90,134,7.5,5.3,0.0,10.7,266940.49609375,2118.2056317159
49226,11207,11207,36047114201,300918,0,Census Tract 1142.01,New York,Kings County,573,1199,630,613,0,550,23,40,17,17,0,17,0,0,569,425,0,365,60,144,184,15.3,6.5,0.0,25.3,523770.6484375,4244.73717543197
49227,11207,11207,36047114202,112266,0,Census Tract 1142.02,New York,Kings County,1297,2337,1457,1378,0,1169,128,81,79,79,0,34,45,0,880,822,0,681,141,58,139,5.9,5.9,0.0,6.6,195421.44921875,2077.2690624817
49228,11207,11207,36047114400,429912,0,Census Tract 1144,New York,Kings County,930,1519,1109,995,0,780,150,65,114,114,0,100,14,0,410,335,0,320,15,75,140,9.2,6.5,0.0,18.3,748132.33984375,4001.97643478033
49229,11207,11207,36047114600,160101,0,Census Tract 1146,New York,Kings County,1147,2416,1372,1263,7,875,265,116,109,104,0,81,23,5,1044,882,0,687,195,162,283,11.7,9.2,4.6,15.5,278662.23828125,2380.20441929695
49230,11207,11207,36047115000,158244,0,Census Tract 1150,New York,Kings County,1144,2142,1350,1216,0,1051,93,72,134,119,0,47,72,15,792,768,0,600,168,24,111,5.2,5.9,11.2,3.0,275388.9296875,2104.8015307290398
49230,11208,11208,36047115000,158244,0,Census Tract 1150,New York,Kings County,1144,2142,1350,1216,0,1051,93,72,134,119,0,47,72,15,792,768,0,600,168,24,111,5.2,5.9,11.2,3.0,275388.9296875,2104.8015307290398
49231,11207,11207,36047115200,166136,0,Census Tract 1152,New York,Kings County,1119,2259,1264,1162,0,1042,77,43,102,102,0,102,0,0,995,868,0,828,40,127,170,7.5,3.7,0.0,12.8,289112.4453125,2154.77746072546
49232,11207,11207,36047115600,159862,0,Census Tract 1156,New York,Kings County,1263,2766,1580,1305,0,1133,130,42,275,275,0,231,44,0,1186,915,0,715,200,271,313,11.3,3.2,0.0,22.8,278154.1640625,2153.41116429007
49233,11207,11207,36047115800,154981,0,Census Tract 1158,New York,Kings County,981,2202,1272,1143,0,809,172,162,129,102,0,88,14,27,930,697,0,621,76,233,422,19.2,14.2,20.9,25.1,269665.359375,2127.7795179974
49234,11207,11207,36047116000,151414,0,Census Tract 1160,New York,Kings County,927,1779,1029,933,0,818,109,6,96,96,0,96,0,0,750,592,0,475,117,158,164,9.2,0.6,0.0,21.1,263464.42578125,2107.81533696558
49235,11207,11207,36047116200,143449,0,Census Tract 1162,New York,Kings County,841,1845,976,859,0,738,103,18,117,104,20,72,12,13,869,695,16,606,73,174,205,11.1,2.1,11.1,20.0,249606.63671875,2065.59936112103
49236,11208,11208,36047116400,181565,0,Census Tract 1164,New York,Kings County,1391,2521,1604,1509,0,1240,151,118,95,78,0,69,9,17,917,794,0,679,115,123,258,10.2,7.8,17.9,13.4,315939.05859375,2270.85517412582
49237,11208,11208,36047116600,159392,0,Census Tract 1166,New York,Kings County,1256,2173,1482,1345,0,1121,135,89,137,137,0,118,19,0,691,659,0,614,45,32,121,5.6,6.6,0.0,4.6,277389.71484375,2111.60382834953
49238,11208,11208,36047116800,143956,0,Census Tract 1168,New York,Kings County,872,1411,982,971,0,872,0,99,11,11,0,11,0,0,429,392,0,387,5,37,136,9.6,10.2,0.0,8.6,250557.640625,2194.08873144571
49239,11207,11207,36047117000,153813,0,Census Tract 1170,New York,Kings County,692,1325,758,709,0,603,89,17,49,40,0,40,0,9,567,536,0,472,64,31,57,4.3,2.4,18.4,5.5,267700.73828125,2146.1111866767396
49239,11208,11208,36047117000,153813,0,Census Tract 1170,New York,Kings County,692,1325,758,709,0,603,89,17,49,40,0,40,0,9,567,536,0,472,64,31,57,4.3,2.4,18.4,5.5,267700.73828125,2146.1111866767396
49240,11207,11207,36047117201,129147,0,Census Tract 1172.01,New York,Kings County,1070,1954,1230,1129,0,922,148,59,101,95,0,95,0,6,724,588,0,517,71,136,201,10.3,5.2,5.9,18.8,224796.05859375,2071.3271066574
49240,11208,11208,36047117201,129147,0,Census Tract 1172.01,New York,Kings County,1070,1954,1230,1129,0,922,148,59,101,95,0,95,0,6,724,588,0,517,71,136,201,10.3,5.2,5.9,18.8,224796.05859375,2071.3271066574
49241,11208,11208,36047117202,151827,0,Census Tract 1172.02,New York,Kings County,1475,2631,1616,1610,0,1367,108,135,6,6,0,6,0,0,1015,832,0,744,88,183,318,12.1,8.4,0.0,18.0,264289.40234375,2088.91460876661
49242,11208,11208,36047117400,212859,0,Census Tract 1174,New York,Kings County,1913,3392,2001,1932,0,1842,71,19,69,69,0,69,0,0,1391,1333,0,1241,92,58,77,2.3,1.0,0.0,4.2,370526.42578125,2750.80358572685
49243,11208,11208,36047117601,152356,0,Census Tract 1176.01,New York,Kings County,1399,2443,1598,1511,6,1243,150,112,87,87,0,87,0,0,845,757,7,666,84,88,200,8.2,7.4,0.0,10.4,265221.78125,2430.44381437413
49244,11208,11208,36047117602,143799,0,Census Tract 1176.02,New York,Kings County,1017,2231,1262,1176,6,831,180,159,86,86,0,56,30,0,969,764,6,675,83,205,364,16.3,13.5,0.0,21.2,250340.39453125,2365.37344264916
49245,11208,11208,36047117800,140598,0,Census Tract 1178,New York,Kings County,740,1481,846,793,0,659,81,53,53,42,0,42,0,11,635,587,0,537,50,48,112,7.6,6.7,20.8,7.6,244731.30078125,2362.78823161224
49246,11208,11208,36047118000,751605,0,Census Tract 1180,New York,Kings County,0,0,0,0,0,0,0,0,0,0,0,0,0,0,0,0,0,0,0,0,0,,,,,1308581.66796875,6362.2370055128895
49247,11208,11208,36047118201,126387,0,Census Tract 1182.01,New York,Kings County,1278,2204,1348,1307,0,1232,46,29,41,41,0,41,0,0,856,799,0,761,38,57,86,3.9,2.2,0.0,6.7,220035.5390625,1964.29551712901
49248,11208,11208,36047118202,124325,0,Census Tract 1182.02,New York,Kings County,1337,2358,1385,1345,7,1290,40,8,40,40,0,40,0,0,973,967,0,909,58,6,14,0.6,0.6,0.0,0.6,216451.0703125,1979.5267852492002
49249,11208,11208,36047118400,204944,0,Census Tract 1184,New York,Kings County,2009,4134,2383,2184,0,1868,141,175,199,187,0,187,0,12,1751,1550,15,1384,151,201,388,9.4,8.0,6.0,11.5,356765.8515625,2400.4978004295003
49250,11208,11208,36047118600,131527,0,Census Tract 1186,New York,Kings County,1163,2221,1272,1194,0,1041,122,31,78,78,0,65,13,0,949,889,0,775,114,60,91,4.1,2.6,0.0,6.3,228941.83203125,2334.55137025677
49251,11208,11208,36047118800,174374,0,Census Tract 1188,New York,Kings County,1759,3736,2000,1891,0,1506,253,132,109,109,0,109,0,0,1736,1595,0,1456,139,141,273,7.3,7.0,0.0,8.1,303503.73828125,2427.4941085195396
49252,11208,11208,36047119000,140618,0,Census Tract 1190,New York,Kings County,890,1841,956,933,0,824,66,43,23,23,0,21,2,0,885,790,0,588,202,95,138,7.5,4.6,0.0,10.7,244747.171875,2721.9768692910397
49253,11208,11208,36047119200,225444,0,Census Tract 1192,New York,Kings County,1250,2349,1457,1355,0,1108,142,105,102,102,0,67,35,0,892,743,0,549,194,149,254,10.8,7.7,0.0,16.7,392364.7890625,2544.82043759703
49254,11208,11208,36047119400,182839,0,Census Tract 1194,New York,Kings County,1564,2818,1846,1632,0,1231,333,68,214,214,0,112,102,0,972,872,0,709,163,100,168,6.0,4.2,0.0,10.3,318173.578125,2260.91493056525
49255,11208,11208,36047119600,306449,0,Census Tract 1196,New York,Kings County,2070,3742,2238,2147,0,1740,330,77,91,91,0,75,16,0,1504,1385,52,977,356,119,196,5.2,3.6,0.0,7.9,533330.0546875,3217.49213260255
49256,11207,11207,36047119800,326903,0,Census Tract 1198,New York,Kings County,1050,2059,1275,1135,10,880,160,85,140,128,0,113,15,12,784,678,12,535,131,106,203,9.9,7.5,8.6,13.5,568933.75,3593.59072151842
49257,11208,11208,36047120000,150529,0,Census Tract 1200,New York,Kings County,926,1844,983,937,0,870,56,11,46,46,0,46,0,0,861,816,0,776,40,45,56,3.0,1.2,0.0,5.2,261962.1171875,2539.3757229646803
49258,11208,11208,36047120200,153056,0,Census Tract 1202,New York,Kings County,650,1556,870,753,0,622,28,103,117,71,0,71,0,46,686,574,0,565,9,112,261,16.8,13.7,39.3,16.3,266372.35546875,2465.82530616412
49259,11208,11208,36047120800,474725,0,Census Tract 1208,New York,Kings County,3499,7162,4041,3772,0,3119,380,273,269,251,0,251,0,18,3121,2636,0,2253,383,485,776,10.8,7.2,6.7,15.5,826081.5703125,4339.39535489875
49260,11208,11208,36047121000,158714,0,Census Tract 1210,New York,Kings County,864,3097,1016,931,0,808,56,67,85,74,0,63,11,11,2081,1527,0,1407,120,554,632,20.4,7.2,12.9,26.6,276171.1875,2260.13141519017
49261,11208,11208,36047121400,173354,0,Census Tract 1214,New York,Kings County,1112,3097,1404,1229,0,1013,99,117,175,164,0,164,0,11,1693,1323,0,1132,191,370,498,16.1,9.5,6.3,21.9,301620.3984375,2216.1046527454896
49262,11208,11208,36047122000,1090388,0,Census Tract 1220,New York,Kings County,2159,4055,2553,2286,0,2003,156,127,267,267,0,267,0,0,1502,1336,0,1036,300,166,293,7.2,5.6,0.0,11.1,1896979.421875,7971.417648115601
49263,11205,11205,36047123700,321360,0,Census Tract 1237,New York,Kings County,1110,2799,1733,1698,0,869,241,588,35,35,0,35,0,0,1066,434,0,284,150,632,1220,43.6,34.6,0.0,59.3,559626.58203125,3013.0332291881396
49264,11215,11215,36047150200,319296,0,Census Tract 1502,New York,Kings County,1708,2200,1765,1725,9,1693,6,17,40,40,0,40,0,0,435,371,8,350,13,64,81,3.7,1.0,0.0,14.7,555343.703125,4480.40607334285
49264,11218,11218,36047150200,319296,0,Census Tract 1502,New York,Kings County,1708,2200,1765,1725,9,1693,6,17,40,40,0,40,0,0,435,371,8,350,13,64,81,3.7,1.0,0.0,14.7,555343.703125,4480.40607334285
49265,11218,11218,36047152200,389862,0,Census Tract 1522,New York,Kings County,1882,2875,2014,1882,0,1865,17,0,132,132,0,132,0,0,861,796,0,782,14,65,65,2.3,0.0,0.0,7.5,677855.41796875,3755.9234482168895
49265,11226,11226,36047152200,389862,0,Census Tract 1522,New York,Kings County,1882,2875,2014,1882,0,1865,17,0,132,132,0,132,0,0,861,796,0,782,14,65,65,2.3,0.0,0.0,7.5,677855.41796875,3755.9234482168895
49273,11040,11004,36059300900,11916557,128626,Census Tract 3009,New York,Nassau County,3611,7017,3782,3702,0,3497,114,91,80,80,0,80,0,0,3235,2839,0,2609,230,396,487,6.9,2.5,0.0,12.2,21023652.2421875,39004.2351486883
49293,11001,11429,36059302600,462020,0,Census Tract 3026,New York,Nassau County,1502,2215,1584,1508,0,1394,108,6,76,76,0,72,4,0,631,570,10,521,39,61,67,3.0,0.4,0.0,9.7,805421.28125,4454.75924743969
49294,11001,11429,36059302700,1009957,0,Census Tract 3027,New York,Nassau County,2320,3822,2401,2331,0,2256,64,11,70,70,0,70,0,0,1421,1324,20,1270,34,97,108,2.8,0.5,0.0,6.8,1761074.25,8176.9385907325905
49294,11040,11004,36059302700,1009957,0,Census Tract 3027,New York,Nassau County,2320,3822,2401,2331,0,2256,64,11,70,70,0,70,0,0,1421,1324,20,1270,34,97,108,2.8,0.5,0.0,6.8,1761074.25,8176.9385907325905
49295,11040,11004,36059302800,2208945,0,Census Tract 3028,New York,Nassau County,3099,5449,3266,3151,0,3099,0,52,115,115,0,115,0,0,2183,1854,0,1742,112,329,381,7.0,1.7,0.0,15.1,3852675.54296875,8796.98023536396
49296,11040,11004,36059302900,1849387,55729,Census Tract 3029,New York,Nassau County,2347,3664,2420,2347,0,2244,103,0,73,73,0,73,0,0,1244,1176,0,1132,44,68,68,1.9,0.0,0.0,5.5,3322527.4609375,8834.66248337536
49297,11040,11004,36059303000,1250502,0,Census Tract 3030,New York,Nassau County,2833,4604,2940,2847,0,2771,62,14,93,93,0,93,0,0,1664,1569,0,1549,20,95,109,2.4,0.5,0.0,5.7,2180167.33203125,6970.857318777321
49298,11040,11004,36059303101,1531360,0,Census Tract 3031.01,New York,Nassau County,1869,2941,1918,1869,0,1869,0,0,49,49,0,49,0,0,1023,988,0,979,9,35,35,1.2,0.0,0.0,3.4,2671723.2890625,9635.9123964776
49299,11040,11004,36059303102,1483898,0,Census Tract 3031.02,New York,Nassau County,1942,3337,2036,1952,0,1902,40,10,84,84,0,73,11,0,1301,1251,0,1161,90,50,60,1.8,0.5,0.0,3.8,2588731.94140625,7251.20773786552
49300,11040,11004,36059303201,1423044,17844,Census Tract 3032.01,New York,Nassau County,1727,3089,1786,1736,0,1701,26,9,50,50,0,50,0,0,1303,1229,0,1229,0,74,83,2.7,0.5,0.0,5.7,2512871.82421875,8580.79111215134
49301,11040,11004,36059303202,1130618,0,Census Tract 3032.02,New York,Nassau County,2143,3500,2249,2187,0,2035,108,44,62,62,0,56,6,0,1251,1097,0,1069,28,154,198,5.7,2.0,0.0,12.3,1971486.484375,6751.15560627838
49316,11001,11429,36059404300,646043,0,Census Tract 4043,New York,Nassau County,1605,2559,1665,1615,9,1582,14,10,50,50,0,50,0,0,894,811,0,767,44,83,93,3.6,0.6,0.0,9.3,1125931.015625,5110.7690590068205
49317,11001,11429,36059404400,1161219,0,Census Tract 4044,New York,Nassau County,2533,4054,2652,2572,0,2533,0,39,80,80,0,80,0,0,1402,1144,0,1060,84,258,297,7.3,1.5,0.0,18.4,2023640.98828125,6897.31713950094
49318,11001,11429,36059404500,1048354,0,Census Tract 4045,New York,Nassau County,2038,3353,2141,2066,33,1982,23,28,75,75,0,75,0,0,1212,1060,8,978,74,152,180,5.4,1.4,0.0,12.5,1827172.60546875,7094.89922926391
49319,11001,11429,36059404600,993706,34951,Census Tract 4046,New York,Nassau County,2309,3507,2394,2309,0,2265,44,0,85,85,0,85,0,0,1113,1043,0,943,100,70,70,2.0,0.0,0.0,6.3,1792454.06640625,6353.793613328759
49320,11001,11429,36059404700,1563658,0,Census Tract 4047,New York,Nassau County,3045,5083,3218,3075,0,2992,53,30,143,143,0,143,0,0,1865,1767,7,1666,94,98,128,2.5,1.0,0.0,5.3,2725345.5,10932.469542585
49320,11040,11004,36059404700,1563658,0,Census Tract 4047,New York,Nassau County,3045,5083,3218,3075,0,2992,53,30,143,143,0,143,0,0,1865,1767,7,1666,94,98,128,2.5,1.0,0.0,5.3,2725345.5,10932.469542585
49321,11001,11429,36059404800,2932267,30398,Census Tract 4048,New York,Nassau County,3324,5154,3540,3351,0,3218,106,27,189,189,0,189,0,0,1614,1504,0,1474,30,110,137,2.7,0.8,0.0,6.8,5161734.1171875,14032.029596333401
49321,11003,11411,36059404800,2932267,30398,Census Tract 4048,New York,Nassau County,3324,5154,3540,3351,0,3218,106,27,189,189,0,189,0,0,1614,1504,0,1474,30,110,137,2.7,0.8,0.0,6.8,5161734.1171875,14032.029596333401
49322,11003,11411,36059404901,1139986,0,Census Tract 4049.01,New York,Nassau County,2891,4764,3108,2915,0,2675,216,24,193,193,0,193,0,0,1656,1626,0,1476,150,30,54,1.1,0.8,0.0,1.8,1985535.3046875,6965.6460412938795
49323,11003,11411,36059404902,633627,0,Census Tract 4049.02,New York,Nassau County,2745,4355,2876,2764,0,2682,63,19,112,112,0,112,0,0,1479,1324,0,1214,110,155,174,4.0,0.7,0.0,10.5,1103655.4921875,4420.46829696935
49324,11003,11411,36059405000,1793486,0,Census Tract 4050,New York,Nassau County,2751,4495,2906,2798,0,2655,96,47,108,108,0,81,27,0,1589,1504,0,1446,58,85,132,2.9,1.7,0.0,5.3,3123680.40234375,8802.69666961918
49325,11003,11411,36059405100,1675508,0,Census Tract 4051,New York,Nassau County,4505,6942,4635,4505,0,4436,69,0,130,130,0,130,0,0,2307,2269,0,2155,114,38,38,0.5,0.0,0.0,1.6,2917354.44140625,9427.119463019391
49326,11003,11411,36059405200,906127,0,Census Tract 4052,New York,Nassau County,3515,5607,3759,3528,0,3313,202,13,231,231,0,231,0,0,1848,1728,0,1595,133,120,133,2.4,0.4,0.0,6.5,1578147.4375,7369.708285039741
49327,11001,11429,36059405301,956016,0,Census Tract 4053.01,New York,Nassau County,1806,3164,1993,1806,0,1742,64,0,187,187,0,187,0,0,1171,1139,0,1044,95,32,32,1.0,0.0,0.0,2.7,1665578.58203125,6633.0722697357205
49327,11003,11411,36059405301,956016,0,Census Tract 4053.01,New York,Nassau County,1806,3164,1993,1806,0,1742,64,0,187,187,0,187,0,0,1171,1139,0,1044,95,32,32,1.0,0.0,0.0,2.7,1665578.58203125,6633.0722697357205
49329,11003,11411,36059405400,1646148,0,Census Tract 4054,New York,Nassau County,4059,7500,4484,4059,0,3903,156,0,425,425,0,284,141,0,3016,2801,45,2465,291,215,215,2.9,0.0,0.0,7.1,2866823.2421875,9138.568448640079
49341,11040,11004,36059406400,4691526,60147,Census Tract 4064,New York,Nassau County,3140,5623,3272,3203,0,3007,133,63,69,69,13,56,0,0,2351,2263,12,2099,152,88,151,2.7,2.0,0.0,3.7,8282876.3515625,12343.9943337409
49384,11003,11411,36059409800,1567565,83143,Census Tract 4098,New York,Nassau County,2929,4882,3089,2960,0,2827,102,31,129,129,0,129,0,0,1793,1706,0,1552,154,87,118,2.4,1.0,0.0,4.9,2873929.31640625,9220.303232756229
49545,10004,10004,36061000100,77654,0,Census Tract 1,New York,New York County,0,0,0,0,0,0,0,0,0,0,0,0,0,0,0,0,0,0,0,0,0,,,,,135191.4765625,2211.0307623801395
49546,10002,10002,36061000201,90233,75976,Census Tract 2.01,New York,New York County,794,2259,1101,1059,0,638,156,265,42,42,0,42,0,0,1158,675,0,464,211,483,748,33.1,25.0,0.0,41.7,157208.51953125,1909.96568689621
49547,10002,10002,36061000202,310040,428737,Census Tract 2.02,New York,New York County,2785,6222,3345,2908,0,2306,479,123,437,437,0,279,158,0,2877,1830,0,1244,586,1047,1170,18.8,4.2,0.0,36.4,520143.69140625,3002.32454750545
49548,10004,10004,36061000500,843918,3393360,Census Tract 5,New York,New York County,0,0,0,0,0,0,0,0,0,0,0,0,0,0,0,0,0,0,0,0,0,,,,,1537268.9140625,12019.836851195701
49549,10002,10002,36061000600,240406,176018,Census Tract 6,New York,New York County,2656,8345,3342,3064,0,2089,567,408,278,158,0,158,0,120,5003,2864,91,1996,777,2139,2667,32.0,13.3,43.2,42.8,440586.48046875,3151.86639999716
49550,10004,10004,36061000700,253658,245812,Census Tract 7,New York,New York County,6740,7864,6977,6764,0,6717,23,24,213,213,0,213,0,0,887,869,0,869,0,18,42,0.5,0.4,0.0,2.0,497558.14453125,5929.841570968741
49550,10005,10005,36061000700,253658,245812,Census Tract 7,New York,New York County,6740,7864,6977,6764,0,6717,23,24,213,213,0,213,0,0,887,869,0,869,0,18,42,0.5,0.4,0.0,2.0,497558.14453125,5929.841570968741
49550,10038,10038,36061000700,253658,245812,Census Tract 7,New York,New York County,6740,7864,6977,6764,0,6717,23,24,213,213,0,213,0,0,887,869,0,869,0,18,42,0.5,0.4,0.0,2.0,497558.14453125,5929.841570968741
49550,10271,10005,36061000700,253658,245812,Census Tract 7,New York,New York County,6740,7864,6977,6764,0,6717,23,24,213,213,0,213,0,0,887,869,0,869,0,18,42,0.5,0.4,0.0,2.0,497558.14453125,5929.841570968741
49551,10002,10002,36061000800,220708,167906,Census Tract 8,New York,New York County,3165,8013,4186,3958,24,2936,205,793,228,164,0,164,0,64,3827,2178,13,1740,425,1649,2506,31.3,20.0,28.1,43.1,384543.7734375,2614.62252735114
49551,10038,10038,36061000800,220708,167906,Census Tract 8,New York,New York County,3165,8013,4186,3958,24,2936,205,793,228,164,0,164,0,64,3827,2178,13,1740,425,1649,2506,31.3,20.0,28.1,43.1,384543.7734375,2614.62252735114
49552,10004,10004,36061000900,302097,473628,Census Tract 9,New York,New York County,1277,1508,1310,1277,0,1214,63,0,33,33,0,29,4,0,198,198,0,194,4,0,0,0.0,0.0,0.0,0.0,587196.24609375,7937.517268401451
49552,10005,10005,36061000900,302097,473628,Census Tract 9,New York,New York County,1277,1508,1310,1277,0,1214,63,0,33,33,0,29,4,0,198,198,0,194,4,0,0,0.0,0.0,0.0,0.0,587196.24609375,7937.517268401451
49553,10002,10002,36061001001,80143,244297,Census Tract 10.01,New York,New York County,685,1271,775,714,0,534,151,29,61,61,0,61,0,0,496,401,0,285,116,95,124,9.8,4.1,0.0,19.2,136076.05078125,1768.6305669062199
49554,10002,10002,36061001002,199683,245138,Census Tract 10.02,New York,New York County,1244,4187,1637,1541,0,773,471,297,96,96,0,96,0,0,2550,1611,0,817,794,939,1236,29.5,19.3,0.0,36.8,348008.65625,2620.95385323864
49555,10002,10002,36061001200,120597,0,Census Tract 12,New York,New York County,1684,3337,1850,1774,0,1385,299,90,76,59,0,59,0,17,1487,987,0,653,334,500,607,18.2,5.1,22.4,33.6,210133.62890625,2197.96899648958
49556,10004,10004,36061001300,317217,0,Census Tract 13,New York,New York County,3563,4096,3647,3563,0,3402,161,0,84,84,0,84,0,0,449,449,0,379,70,0,0,0.0,0.0,0.0,0.0,552622.40234375,3522.5319342263792
49556,10006,10006,36061001300,317217,0,Census Tract 13,New York,New York County,3563,4096,3647,3563,0,3402,161,0,84,84,0,84,0,0,449,449,0,379,70,0,0,0.0,0.0,0.0,0.0,552622.40234375,3522.5319342263792
49556,10007,10007,36061001300,317217,0,Census Tract 13,New York,New York County,3563,4096,3647,3563,0,3402,161,0,84,84,0,84,0,0,449,449,0,379,70,0,0,0.0,0.0,0.0,0.0,552622.40234375,3522.5319342263792
49557,10002,10002,36061001401,93505,0,Census Tract 14.01,New York,New York County,1728,2660,1799,1766,0,1563,165,38,33,33,0,33,0,0,861,648,0,545,103,213,251,9.4,2.2,0.0,24.7,162923.140625,2039.7856331059802
49558,10002,10002,36061001402,113920,0,Census Tract 14.02,New York,New York County,1406,2659,1509,1476,0,1226,180,70,33,33,0,17,16,0,1150,708,0,405,303,442,512,19.3,4.7,0.0,38.4,198507.078125,1794.5468872058898
49559,10038,10038,36061001501,257851,175058,Census Tract 15.01,New York,New York County,3567,5875,3795,3662,23,3384,160,95,133,133,0,133,0,0,2080,1718,48,1536,134,362,457,7.8,2.6,0.0,17.4,452072.11328125,3948.83250657021
49560,10004,10004,36061001502,207277,146802,Census Tract 15.02,New York,New York County,5411,6626,5653,5446,0,5301,110,35,207,207,0,207,0,0,973,917,0,917,0,56,91,1.4,0.6,0.0,5.8,377984.40625,4335.66019200817
49560,10005,10005,36061001502,207277,146802,Census Tract 15.02,New York,New York County,5411,6626,5653,5446,0,5301,110,35,207,207,0,207,0,0,973,917,0,917,0,56,91,1.4,0.6,0.0,5.8,377984.40625,4335.66019200817
49560,10038,10038,36061001502,207277,146802,Census Tract 15.02,New York,New York County,5411,6626,5653,5446,0,5301,110,35,207,207,0,207,0,0,973,917,0,917,0,56,91,1.4,0.6,0.0,5.8,377984.40625,4335.66019200817
49561,10002,10002,36061001600,207381,0,Census Tract 16,New York,New York County,3196,6524,3955,3651,21,2775,400,455,304,272,0,208,64,32,2569,1997,0,1516,481,572,1059,16.2,12.5,10.5,22.3,361351.69921875,2570.1689071248197
49562,10002,10002,36061001800,222968,0,Census Tract 18,New York,New York County,3490,6291,4146,3965,0,3059,431,475,181,181,0,150,31,0,2145,1275,0,889,386,870,1345,21.4,12.0,0.0,40.6,388544.23828125,2570.43840656329
49563,10002,10002,36061002000,126280,137883,Census Tract 20,New York,New York County,1017,3692,1270,1175,0,847,170,158,95,51,0,51,0,44,2422,1646,0,1079,567,776,978,26.5,13.4,46.3,32.0,220063.1875,2014.2057881610397
49563,10009,10009,36061002000,126280,137883,Census Tract 20,New York,New York County,1017,3692,1270,1175,0,847,170,158,95,51,0,51,0,44,2422,1646,0,1079,567,776,978,26.5,13.4,46.3,32.0,220063.1875,2014.2057881610397
49564,10007,10007,36061002100,237228,0,Census Tract 21,New York,New York County,3781,4803,3809,3795,0,3737,44,14,14,14,0,14,0,0,994,927,0,876,51,67,81,1.7,0.4,0.0,6.7,413336.31640625,2710.4549632601
49564,10013,10013,36061002100,237228,0,Census Tract 21,New York,New York County,3781,4803,3809,3795,0,3737,44,14,14,14,0,14,0,0,994,927,0,876,51,67,81,1.7,0.4,0.0,6.7,413336.31640625,2710.4549632601
49564,10279,10007,36061002100,237228,0,Census Tract 21,New York,New York County,3781,4803,3809,3795,0,3737,44,14,14,14,0,14,0,0,994,927,0,876,51,67,81,1.7,0.4,0.0,6.7,413336.31640625,2710.4549632601
49565,10002,10002,36061002201,161667,0,Census Tract 22.01,New York,New York County,2521,5779,2802,2607,35,1900,586,86,195,195,0,147,48,0,2977,2159,0,1412,747,818,904,15.6,3.3,0.0,27.5,281719.296875,2325.38971461754
49566,10009,10009,36061002202,56112,0,Census Tract 22.02,New York,New York County,1237,1734,1322,1292,0,758,479,55,30,30,0,30,0,0,412,338,0,219,119,74,129,7.4,4.3,0.0,18.0,97786.0859375,1534.68539304728
49567,10009,10009,36061002400,182346,470253,Census Tract 24,New York,New York County,963,3530,1149,1046,21,702,240,83,103,103,0,56,47,0,2381,1911,31,1118,762,470,553,15.7,7.9,0.0,19.7,317800.890625,2475.2397800889803
49568,10038,10038,36061002500,131517,94115,Census Tract 25,New York,New York County,1309,4525,1847,1603,0,1191,118,294,244,244,0,235,9,0,2678,1710,24,1304,382,968,1262,27.9,18.3,0.0,36.1,228005.1171875,2029.09505090023
49569,10009,10009,36061002601,106047,0,Census Tract 26.01,New York,New York County,1680,2981,1909,1849,0,1304,376,169,60,60,0,60,0,0,1072,738,0,348,390,334,503,16.9,9.1,0.0,31.2,184814.5546875,1819.396212995
49570,10009,10009,36061002602,103691,0,Census Tract 26.02,New York,New York County,2395,3598,2525,2427,0,2044,351,32,98,98,0,98,0,0,1073,681,0,556,125,392,424,11.8,1.3,0.0,36.5,180720.18359375,1806.4883637799699
49571,10038,10038,36061002700,59282,0,Census Tract 27,New York,New York County,597,1240,719,683,0,585,12,86,36,27,0,27,0,9,521,308,0,257,51,213,308,24.8,12.6,25.0,40.9,103284.88671875,1483.4067578719698
49572,10009,10009,36061002800,183616,0,Census Tract 28,New York,New York County,3084,5551,3342,3227,0,2177,907,143,115,115,0,75,40,0,2209,1735,0,1076,659,474,617,11.1,4.4,0.0,21.5,320039.59375,2262.27799828148
49573,10007,10007,36061002900,273358,0,Census Tract 29,New York,New York County,1738,4148,2166,2041,0,1273,465,303,125,79,0,43,36,46,1982,896,0,634,262,1086,1435,34.6,14.8,36.8,54.8,476286.7734375,3494.50246032122
49573,10013,10013,36061002900,273358,0,Census Tract 29,New York,New York County,1738,4148,2166,2041,0,1273,465,303,125,79,0,43,36,46,1982,896,0,634,262,1086,1435,34.6,14.8,36.8,54.8,476286.7734375,3494.50246032122
49573,10038,10038,36061002900,273358,0,Census Tract 29,New York,New York County,1738,4148,2166,2041,0,1273,465,303,125,79,0,43,36,46,1982,896,0,634,262,1086,1435,34.6,14.8,36.8,54.8,476286.7734375,3494.50246032122
49574,10002,10002,36061003001,124153,0,Census Tract 30.01,New York,New York County,2752,3734,3150,2905,0,2022,730,153,245,245,0,231,14,0,584,508,0,359,149,76,229,6.1,5.3,0.0,13.0,216362.1796875,1906.6118758512198
49575,10009,10009,36061003002,78525,0,Census Tract 30.02,New York,New York County,1681,2662,1864,1830,6,1222,453,149,34,34,0,34,0,0,798,617,0,325,292,181,330,12.4,8.1,0.0,22.7,136851.31640625,1630.2593192639301
49576,10007,10007,36061003100,204969,0,Census Tract 31,New York,New York County,1035,1325,1079,1040,0,1008,27,5,39,39,0,39,0,0,246,178,0,152,26,68,73,5.5,0.5,0.0,27.6,357138.22265625,3206.8894650033803
49576,10013,10013,36061003100,204969,0,Census Tract 31,New York,New York County,1035,1325,1079,1040,0,1008,27,5,39,39,0,39,0,0,246,178,0,152,26,68,73,5.5,0.5,0.0,27.6,357138.22265625,3206.8894650033803
49576,10278,10007,36061003100,204969,0,Census Tract 31,New York,New York County,1035,1325,1079,1040,0,1008,27,5,39,39,0,39,0,0,246,178,0,152,26,68,73,5.5,0.5,0.0,27.6,357138.22265625,3206.8894650033803
49577,10009,10009,36061003200,217682,0,Census Tract 32,New York,New York County,4613,7450,4839,4665,79,3264,1270,52,174,174,0,174,0,0,2611,2236,53,1261,922,375,427,5.7,1.1,0.0,14.4,379406.59375,2564.17703528862
49578,10007,10007,36061003300,341677,0,Census Tract 33,New York,New York County,3116,4129,3363,3127,0,3082,34,11,236,236,0,236,0,0,766,766,0,678,88,0,11,0.3,0.4,0.0,0.0,595401.2265625,3289.67940780425
49578,10013,10013,36061003300,341677,0,Census Tract 33,New York,New York County,3116,4129,3363,3127,0,3082,34,11,236,236,0,236,0,0,766,766,0,678,88,0,11,0.3,0.4,0.0,0.0,595401.2265625,3289.67940780425
49579,10009,10009,36061003400,160257,0,Census Tract 34,New York,New York County,4148,6101,4455,4148,0,3757,391,0,307,195,0,195,0,112,1646,1455,0,1171,284,191,303,5.0,0.0,36.5,11.6,279345.73828125,2222.25823643566
49580,10002,10002,36061003601,99812,0,Census Tract 36.01,New York,New York County,1443,2815,1804,1657,0,1310,133,214,147,139,0,139,0,8,1011,752,0,609,143,259,481,17.1,12.9,5.4,25.6,173946.63671875,1673.36143883446
49581,10003,10003,36061003602,89011,0,Census Tract 36.02,New York,New York County,1745,2300,1886,1745,0,1502,243,0,141,141,0,132,9,0,414,331,0,308,23,83,83,3.6,0.0,0.0,20.0,155132.203125,1638.91318912889
49582,10012,10012,36061003700,383376,322356,Census Tract 37,New York,New York County,1653,2151,1699,1662,0,1637,16,9,37,37,0,37,0,0,452,410,10,386,14,42,51,2.4,0.5,0.0,9.3,714943.06640625,5627.20923846385
49582,10013,10013,36061003700,383376,322356,Census Tract 37,New York,New York County,1653,2151,1699,1662,0,1637,16,9,37,37,0,37,0,0,452,410,10,386,14,42,51,2.4,0.5,0.0,9.3,714943.06640625,5627.20923846385
49582,10014,10014,36061003700,383376,322356,Census Tract 37,New York,New York County,1653,2151,1699,1662,0,1637,16,9,37,37,0,37,0,0,452,410,10,386,14,42,51,2.4,0.5,0.0,9.3,714943.06640625,5627.20923846385
49583,10003,10003,36061003800,202371,0,Census Tract 38,New York,New York County,5447,8230,5902,5656,83,4546,818,209,246,246,0,184,62,0,2328,2179,86,1903,190,149,358,4.3,3.7,0.0,6.4,352735.83203125,2350.19719646419
49584,10013,10013,36061003900,331071,447417,Census Tract 39,New York,New York County,3230,4735,3424,3340,0,3093,137,110,84,84,0,84,0,0,1311,1155,0,1122,33,156,266,5.6,3.3,0.0,11.9,576955.65625,5168.01668660455
49585,10003,10003,36061004000,178340,0,Census Tract 40,New York,New York County,4714,6083,4914,4783,0,4413,301,69,131,131,0,120,11,0,1169,1057,0,986,71,112,181,3.0,1.4,0.0,9.6,310881.953125,2235.36191820323
49586,10012,10012,36061004100,191276,0,Census Tract 41,New York,New York County,4358,7116,5019,4901,0,3784,574,543,118,118,0,118,0,0,2097,1468,0,1262,206,629,1172,16.5,11.1,0.0,30.0,333315.67578125,2380.58061477903
49586,10013,10013,36061004100,191276,0,Census Tract 41,New York,New York County,4358,7116,5019,4901,0,3784,574,543,118,118,0,118,0,0,2097,1468,0,1262,206,629,1172,16.5,11.1,0.0,30.0,333315.67578125,2380.58061477903
49587,10003,10003,36061004200,85566,0,Census Tract 42,New York,New York County,1797,2427,1921,1797,0,1627,170,0,124,124,0,65,59,0,506,492,0,386,106,14,14,0.6,0.0,0.0,2.8,149163.5234375,2274.46286732243
49588,10012,10012,36061004300,149239,0,Census Tract 43,New York,New York County,2383,3677,2507,2444,0,2314,69,61,63,63,0,63,0,0,1170,976,0,882,94,194,255,6.9,2.5,0.0,16.6,260094.65234375,2048.2304270026398
49589,10009,10009,36061004400,410011,465240,Census Tract 44,New York,New York County,10562,15115,10829,10562,0,9476,1086,0,267,221,0,221,0,46,4286,3762,0,3230,532,524,570,3.8,0.0,17.2,12.2,716623.08203125,4247.74340123555
49590,10012,10012,36061004500,104947,0,Census Tract 45,New York,New York County,494,810,529,515,0,494,0,21,14,14,0,14,0,0,281,230,0,225,5,51,72,8.9,4.1,0.0,18.1,182887.06640625,1853.7608062580398
49590,10013,10013,36061004500,104947,0,Census Tract 45,New York,New York County,494,810,529,515,0,494,0,21,14,14,0,14,0,0,281,230,0,225,5,51,72,8.9,4.1,0.0,18.1,182887.06640625,1853.7608062580398
49591,10012,10012,36061004700,165421,0,Census Tract 47,New York,New York County,1507,2027,1562,1507,0,1471,36,0,55,55,0,28,27,0,465,456,0,427,29,9,9,0.4,0.0,0.0,1.9,288292.21875,2410.02741743449
49591,10013,10013,36061004700,165421,0,Census Tract 47,New York,New York County,1507,2027,1562,1507,0,1471,36,0,55,55,0,28,27,0,465,456,0,427,29,9,9,0.4,0.0,0.0,1.9,288292.21875,2410.02741743449
49592,10003,10003,36061004800,175756,0,Census Tract 48,New York,New York County,3398,4670,3494,3398,17,3313,68,0,96,96,0,96,0,0,1176,1016,0,983,33,160,160,3.4,0.0,0.0,13.6,306405.71484375,2213.5490440515
49593,10012,10012,36061004900,207320,0,Census Tract 49,New York,New York County,2831,3968,2941,2831,0,2706,125,0,110,110,0,66,44,0,1027,946,0,914,32,81,81,2.0,0.0,0.0,7.9,361338.62109375,2679.09052802719
49594,10003,10003,36061005000,166467,0,Census Tract 50,New York,New York County,3540,4614,3811,3587,0,3495,45,47,224,224,0,224,0,0,803,756,0,725,31,47,94,2.0,1.3,0.0,5.9,290229.44140625,2203.0513758505604
49594,10010,10010,36061005000,166467,0,Census Tract 50,New York,New York County,3540,4614,3811,3587,0,3495,45,47,224,224,0,224,0,0,803,756,0,725,31,47,94,2.0,1.3,0.0,5.9,290229.44140625,2203.0513758505604
49595,10003,10003,36061005200,168892,0,Census Tract 52,New York,New York County,1614,2198,1690,1629,0,1516,98,15,61,61,0,61,0,0,508,476,0,426,50,32,47,2.1,0.9,0.0,6.3,294469.1875,2330.38322924436
49595,10010,10010,36061005200,168892,0,Census Tract 52,New York,New York County,1614,2198,1690,1629,0,1516,98,15,61,61,0,61,0,0,508,476,0,426,50,32,47,2.1,0.9,0.0,6.3,294469.1875,2330.38322924436
49596,10010,10010,36061005400,167959,0,Census Tract 54,New York,New York County,3050,4003,3138,3050,0,3027,23,0,88,88,0,88,0,0,865,764,0,723,41,101,101,2.5,0.0,0.0,11.7,292856.359375,2249.02104587304
49596,10011,10011,36061005400,167959,0,Census Tract 54,New York,New York County,3050,4003,3138,3050,0,3027,23,0,88,88,0,88,0,0,865,764,0,723,41,101,101,2.5,0.0,0.0,11.7,292856.359375,2249.02104587304
49597,10012,10012,36061005501,124447,0,Census Tract 55.01,New York,New York County,2477,3572,2519,2493,0,2393,84,16,26,26,0,13,13,0,1053,997,0,980,17,56,72,2.0,0.6,0.0,5.3,216914.80078125,1871.6774513400198
49598,10003,10003,36061005502,115486,0,Census Tract 55.02,New York,New York County,1232,1668,1331,1240,0,1128,104,8,91,91,0,91,0,0,337,322,0,310,12,15,23,1.4,0.6,0.0,4.5,201287.2578125,1830.02046326238
49598,10012,10012,36061005502,115486,0,Census Tract 55.02,New York,New York County,1232,1668,1331,1240,0,1128,104,8,91,91,0,91,0,0,337,322,0,310,12,15,23,1.4,0.6,0.0,4.5,201287.2578125,1830.02046326238
49599,10010,10010,36061005600,174425,0,Census Tract 56,New York,New York County,2076,3103,2209,2101,0,1974,102,25,108,108,0,86,22,0,894,582,0,436,146,312,337,10.9,1.2,0.0,34.9,304154.8046875,2304.1906027960604
49599,10016,10016,36061005600,174425,0,Census Tract 56,New York,New York County,2076,3103,2209,2101,0,1974,102,25,108,108,0,86,22,0,894,582,0,436,146,312,337,10.9,1.2,0.0,34.9,304154.8046875,2304.1906027960604
49600,10003,10003,36061005700,108055,0,Census Tract 57,New York,New York County,1677,2400,1746,1687,0,1647,30,10,59,59,0,59,0,0,654,608,0,586,22,46,56,2.3,0.6,0.0,7.0,188353.3515625,1911.85496376102
49601,10001,10001,36061005800,174669,0,Census Tract 58,New York,New York County,2602,3180,2744,2602,0,2387,215,0,142,142,0,117,25,0,436,436,0,397,39,0,0,0.0,0.0,0.0,0.0,304595.12109375,2304.0001457693397
49601,10010,10010,36061005800,174669,0,Census Tract 58,New York,New York County,2602,3180,2744,2602,0,2387,215,0,142,142,0,117,25,0,436,436,0,397,39,0,0,0.0,0.0,0.0,0.0,304595.12109375,2304.0001457693397
49602,10003,10003,36061005900,116172,0,Census Tract 59,New York,New York County,2892,4244,2991,2922,0,2773,119,30,69,69,0,69,0,0,1253,1209,0,1113,96,44,74,1.7,1.0,0.0,3.5,202516.671875,2125.06313221205
49603,10010,10010,36061006000,118943,300815,Census Tract 60,New York,New York County,3127,4311,3197,3127,12,2979,136,0,70,70,0,70,0,0,1114,845,15,774,56,269,269,6.2,0.0,0.0,24.1,238658.66796875,3468.95131367062
49604,10003,10003,36061006100,142173,0,Census Tract 61,New York,New York County,2430,3268,2527,2443,0,2196,234,13,84,84,0,84,0,0,741,719,0,626,93,22,35,1.1,0.5,0.0,3.0,247858.8515625,2021.6724114269898
49605,10010,10010,36061006200,293511,862281,Census Tract 62,New York,New York County,1641,2424,1668,1647,15,1521,105,6,21,21,0,21,0,0,756,703,0,665,38,53,59,2.4,0.4,0.0,7.0,554401.62109375,5966.17174872576
49605,10016,10016,36061006200,293511,862281,Census Tract 62,New York,New York County,1641,2424,1668,1647,15,1521,105,6,21,21,0,21,0,0,756,703,0,665,38,53,59,2.4,0.4,0.0,7.0,554401.62109375,5966.17174872576
49606,10011,10011,36061006300,178187,0,Census Tract 63,New York,New York County,3744,5645,3870,3782,35,3631,78,38,88,88,0,88,0,0,1775,1681,19,1606,56,94,132,2.3,1.0,0.0,5.3,310650.06640625,2335.98039767055
49607,10003,10003,36061006400,179196,0,Census Tract 64,New York,New York County,5477,6828,5614,5479,0,5103,374,2,135,135,0,135,0,0,1214,1116,0,1087,29,98,100,1.5,0.0,0.0,8.1,312429.890625,2231.14217386783
49607,10010,10010,36061006400,179196,0,Census Tract 64,New York,New York County,5477,6828,5614,5479,0,5103,374,2,135,135,0,135,0,0,1214,1116,0,1087,29,98,100,1.5,0.0,0.0,8.1,312429.890625,2231.14217386783
49608,10003,10003,36061006500,201131,0,Census Tract 65,New York,New York County,3947,5364,4064,3947,0,3604,343,0,117,117,0,104,13,0,1300,1199,0,1069,130,101,101,1.9,0.0,0.0,7.8,350603.05859375,2554.8546474411
49608,10011,10011,36061006500,201131,0,Census Tract 65,New York,New York County,3947,5364,4064,3947,0,3604,343,0,117,117,0,104,13,0,1300,1199,0,1069,130,101,101,1.9,0.0,0.0,7.8,350603.05859375,2554.8546474411
49608,10012,10012,36061006500,201131,0,Census Tract 65,New York,New York County,3947,5364,4064,3947,0,3604,343,0,117,117,0,104,13,0,1300,1199,0,1069,130,101,101,1.9,0.0,0.0,7.8,350603.05859375,2554.8546474411
49609,10010,10010,36061006600,174705,0,Census Tract 66,New York,New York County,5965,9238,6425,6275,0,5594,371,310,150,150,0,99,51,0,2813,1953,103,1740,110,860,1170,12.7,4.9,0.0,30.6,304627.28125,2212.14400103832
49609,10016,10016,36061006600,174705,0,Census Tract 66,New York,New York County,5965,9238,6425,6275,0,5594,371,310,150,150,0,99,51,0,2813,1953,103,1740,110,860,1170,12.7,4.9,0.0,30.6,304627.28125,2212.14400103832
49610,10014,10014,36061006700,168478,0,Census Tract 67,New York,New York County,3836,5034,4037,3886,0,3735,101,50,151,151,0,151,0,0,997,767,0,679,88,230,280,5.6,1.3,0.0,23.1,293688.28125,2198.8592281654
49611,10010,10010,36061006800,174444,0,Census Tract 68,New York,New York County,4588,5935,4942,4626,0,4523,65,38,316,316,0,316,0,0,993,780,0,780,0,213,251,4.2,0.8,0.0,21.5,304176.390625,2304.95696348154
49611,10016,10016,36061006800,174444,0,Census Tract 68,New York,New York County,4588,5935,4942,4626,0,4523,65,38,316,316,0,316,0,0,993,780,0,780,0,213,251,4.2,0.8,0.0,21.5,304176.390625,2304.95696348154
49612,10014,10014,36061006900,220486,275547,Census Tract 69,New York,New York County,1450,1923,1499,1475,0,1397,53,25,24,6,0,6,0,18,424,416,0,406,10,8,51,2.7,1.7,75.0,1.9,394067.28125,3839.2510573975105
49613,10016,10016,36061007000,177329,0,Census Tract 70,New York,New York County,5379,7425,5538,5418,0,5237,142,39,120,120,0,120,0,0,1887,1692,0,1545,147,195,234,3.2,0.7,0.0,10.3,309233.921875,2228.1209506443697
49614,10011,10011,36061007100,164996,0,Census Tract 71,New York,New York County,3799,4741,3891,3816,0,3769,30,17,75,75,0,75,0,0,850,734,30,668,36,116,133,2.8,0.4,0.0,13.6,287666.40234375,2656.84852051156
49614,10014,10014,36061007100,164996,0,Census Tract 71,New York,New York County,3799,4741,3891,3816,0,3769,30,17,75,75,0,75,0,0,850,734,30,668,36,116,133,2.8,0.4,0.0,13.6,287666.40234375,2656.84852051156
49615,10016,10016,36061007200,175015,0,Census Tract 72,New York,New York County,4944,6702,5335,5164,37,4840,67,220,171,171,0,171,0,0,1367,1259,0,1175,84,108,328,4.9,4.3,0.0,7.9,305217.875,2305.2853140945103
49616,10014,10014,36061007300,165299,0,Census Tract 73,New York,New York County,3995,5422,4331,3995,25,3970,0,0,336,336,44,213,79,0,1091,1056,0,1056,0,35,35,0.6,0.0,0.0,3.2,288178.78515625,2315.50398607368
49617,10016,10016,36061007400,174085,0,Census Tract 74,New York,New York County,2777,3316,2827,2777,0,2707,70,0,50,50,0,50,0,0,489,343,0,310,33,146,146,4.4,0.0,0.0,29.9,303602.55078125,2305.1129775807603
49618,10014,10014,36061007500,165732,283835,Census Tract 75,New York,New York County,2481,3308,2657,2481,0,2393,88,0,176,159,0,159,0,17,651,575,0,575,0,76,93,2.8,0.0,9.7,11.7,313420.94140625,4034.71257766055
49619,10001,10001,36061007600,174274,0,Census Tract 76,New York,New York County,1441,1867,1498,1447,10,1382,49,6,51,51,0,51,0,0,369,325,15,310,0,44,50,2.7,0.4,0.0,11.9,303951.046875,2302.78459526695
49620,10011,10011,36061007700,178798,0,Census Tract 77,New York,New York County,4408,5735,4617,4408,0,4316,92,0,209,209,0,209,0,0,1118,897,25,827,45,221,221,3.9,0.0,0.0,19.8,311750.3125,2323.97210408151
49620,10014,10014,36061007700,178798,0,Census Tract 77,New York,New York County,4408,5735,4617,4408,0,4316,92,0,209,209,0,209,0,0,1118,897,25,827,45,221,221,3.9,0.0,0.0,19.8,311750.3125,2323.97210408151
49621,10016,10016,36061007800,177474,0,Census Tract 78,New York,New York County,6002,8082,6411,6051,0,6002,0,49,360,289,0,289,0,71,1671,1502,0,1423,79,169,289,3.6,0.8,19.7,10.1,309513.34375,2227.2403093616
49622,10014,10014,36061007900,285955,502030,Census Tract 79,New York,New York County,2146,3815,2314,2146,0,2068,78,0,168,168,0,152,16,0,1501,1393,0,1393,0,108,108,2.8,0.0,0.0,7.2,511073.13671875,5051.9603450674895
49623,10016,10016,36061008000,172626,0,Census Tract 80,New York,New York County,3379,4533,3484,3415,0,3259,120,36,69,69,0,69,0,0,1049,796,0,719,77,253,289,6.4,1.1,0.0,24.1,301088.53125,2287.6226830896803
49623,10017,10017,36061008000,172626,0,Census Tract 80,New York,New York County,3379,4533,3484,3415,0,3259,120,36,69,69,0,69,0,0,1049,796,0,719,77,253,289,6.4,1.1,0.0,24.1,301088.53125,2287.6226830896803
49623,10168,10017,36061008000,172626,0,Census Tract 80,New York,New York County,3379,4533,3484,3415,0,3259,120,36,69,69,0,69,0,0,1049,796,0,719,77,253,289,6.4,1.1,0.0,24.1,301088.53125,2287.6226830896803
49624,10011,10011,36061008100,174287,0,Census Tract 81,New York,New York County,5142,7110,5538,5325,34,4985,123,183,213,188,0,188,0,25,1572,1299,38,1261,0,273,481,6.8,3.4,11.7,17.4,303902.51953125,2286.7780005749105
49625,10016,10016,36061008200,172401,0,Census Tract 82,New York,New York County,2461,2965,2479,2461,0,2461,0,0,18,18,0,18,0,0,486,486,0,408,78,0,0,0.0,0.0,0.0,0.0,300707.4453125,2287.34864984756
49625,10017,10017,36061008200,172401,0,Census Tract 82,New York,New York County,2461,2965,2479,2461,0,2461,0,0,18,18,0,18,0,0,486,486,0,408,78,0,0,0.0,0.0,0.0,0.0,300707.4453125,2287.34864984756
49625,10165,10017,36061008200,172401,0,Census Tract 82,New York,New York County,2461,2965,2479,2461,0,2461,0,0,18,18,0,18,0,0,486,486,0,408,78,0,0,0.0,0.0,0.0,0.0,300707.4453125,2287.34864984756
49626,10011,10011,36061008300,174158,0,Census Tract 83,New York,New York County,2222,3525,2530,2222,0,2222,0,0,308,308,0,308,0,0,995,659,0,643,16,336,336,9.5,0.0,0.0,33.8,303694.0859375,2286.10866801953
49626,10014,10014,36061008300,174158,0,Census Tract 83,New York,New York County,2222,3525,2530,2222,0,2222,0,0,308,308,0,308,0,0,995,659,0,643,16,336,336,9.5,0.0,0.0,33.8,303694.0859375,2286.10866801953
49627,10018,10018,36061008400,173067,0,Census Tract 84,New York,New York County,1380,1817,1432,1380,0,1343,37,0,52,52,0,52,0,0,385,385,0,357,28,0,0,0.0,0.0,0.0,0.0,301880.71875,2291.4977087622196
49627,10036,10036,36061008400,173067,0,Census Tract 84,New York,New York County,1380,1817,1432,1380,0,1343,37,0,52,52,0,52,0,0,385,385,0,357,28,0,0,0.0,0.0,0.0,0.0,301880.71875,2291.4977087622196
49628,10016,10016,36061008601,125340,499842,Census Tract 86.01,New York,New York County,2177,2762,2266,2198,0,2121,56,21,68,68,0,68,0,0,496,475,0,459,16,21,42,1.5,1.0,0.0,4.2,220166.28125,2772.25658578587
49628,10017,10017,36061008601,125340,499842,Census Tract 86.01,New York,New York County,2177,2762,2266,2198,0,2121,56,21,68,68,0,68,0,0,496,475,0,459,16,21,42,1.5,1.0,0.0,4.2,220166.28125,2772.25658578587
49629,10017,10017,36061008602,106753,317001,Census Tract 86.02,New York,New York County,0,0,0,0,0,0,0,0,0,0,0,0,0,0,0,0,0,0,0,0,0,,,,,196872.6796875,2007.7660290030103
49630,10017,10017,36061008603,116670,153941,Census Tract 86.03,New York,New York County,2541,3835,2714,2557,0,2415,126,16,157,157,0,157,0,0,1121,1054,0,1001,53,67,83,2.2,0.6,0.0,6.0,228080.31640625,2051.27843548325
49630,10022,10022,36061008603,116670,153941,Census Tract 86.03,New York,New York County,2541,3835,2714,2557,0,2415,126,16,157,157,0,157,0,0,1121,1054,0,1001,53,67,83,2.2,0.6,0.0,6.0,228080.31640625,2051.27843548325
49631,10011,10011,36061008700,165443,0,Census Tract 87,New York,New York County,5256,6528,5543,5445,0,5227,29,189,98,98,0,98,0,0,985,822,0,806,16,163,352,5.4,3.5,0.0,16.5,288498.97265625,2244.63719107383
49632,10016,10016,36061008800,179256,0,Census Tract 88,New York,New York County,4610,6603,4844,4610,0,4366,244,0,234,234,0,234,0,0,1759,1651,0,1651,0,108,108,1.6,0.0,0.0,6.1,312653.39453125,2258.8759461744103
49632,10017,10017,36061008800,179256,0,Census Tract 88,New York,New York County,4610,6603,4844,4610,0,4366,244,0,234,234,0,234,0,0,1759,1651,0,1651,0,108,108,1.6,0.0,0.0,6.1,312653.39453125,2258.8759461744103
49633,10011,10011,36061008900,165578,0,Census Tract 89,New York,New York County,3264,4285,3461,3313,0,3220,44,49,148,86,0,86,0,62,824,721,0,721,0,103,214,5.0,1.5,41.9,12.5,288756.109375,2244.88540648553
49634,10017,10017,36061009000,174693,0,Census Tract 90,New York,New York County,5513,6918,5566,5513,0,5167,346,0,53,53,0,53,0,0,1352,1286,0,1231,55,66,66,1.0,0.0,0.0,4.9,304720.40625,2233.76520887698
49635,10001,10001,36061009100,179099,0,Census Tract 91,New York,New York County,4530,5703,4732,4596,0,4406,124,66,136,136,0,136,0,0,971,971,41,790,140,0,66,1.2,1.4,0.0,0.0,312333.265625,2311.1891342515
49635,10011,10011,36061009100,179099,0,Census Tract 91,New York,New York County,4530,5703,4732,4596,0,4406,124,66,136,136,0,136,0,0,971,971,41,790,140,0,66,1.2,1.4,0.0,0.0,312333.265625,2311.1891342515
49636,10017,10017,36061009200,197023,0,Census Tract 92,New York,New York County,1234,1532,1277,1241,0,1165,69,7,36,36,0,28,8,0,255,229,0,229,0,26,33,2.2,0.6,0.0,10.2,343684.7265625,2487.7022320208102
49636,10167,10017,36061009200,197023,0,Census Tract 92,New York,New York County,1234,1532,1277,1241,0,1165,69,7,36,36,0,28,8,0,255,229,0,229,0,26,33,2.2,0.6,0.0,10.2,343684.7265625,2487.7022320208102
49636,10169,10017,36061009200,197023,0,Census Tract 92,New York,New York County,1234,1532,1277,1241,0,1165,69,7,36,36,0,28,8,0,255,229,0,229,0,26,33,2.2,0.6,0.0,10.2,343684.7265625,2487.7022320208102
49636,10170,10017,36061009200,197023,0,Census Tract 92,New York,New York County,1234,1532,1277,1241,0,1165,69,7,36,36,0,28,8,0,255,229,0,229,0,26,33,2.2,0.6,0.0,10.2,343684.7265625,2487.7022320208102
49636,10171,10017,36061009200,197023,0,Census Tract 92,New York,New York County,1234,1532,1277,1241,0,1165,69,7,36,36,0,28,8,0,255,229,0,229,0,26,33,2.2,0.6,0.0,10.2,343684.7265625,2487.7022320208102
49636,10172,10017,36061009200,197023,0,Census Tract 92,New York,New York County,1234,1532,1277,1241,0,1165,69,7,36,36,0,28,8,0,255,229,0,229,0,26,33,2.2,0.6,0.0,10.2,343684.7265625,2487.7022320208102
49636,10174,10017,36061009200,197023,0,Census Tract 92,New York,New York County,1234,1532,1277,1241,0,1165,69,7,36,36,0,28,8,0,255,229,0,229,0,26,33,2.2,0.6,0.0,10.2,343684.7265625,2487.7022320208102
49637,10001,10001,36061009300,179098,0,Census Tract 93,New York,New York County,5317,8387,5851,5563,0,5036,281,246,288,288,0,288,0,0,2536,2083,0,2000,83,453,699,8.3,4.4,0.0,17.9,312358.3828125,2310.20960006097
49637,10011,10011,36061009300,179098,0,Census Tract 93,New York,New York County,5317,8387,5851,5563,0,5036,281,246,288,288,0,288,0,0,2536,2083,0,2000,83,453,699,8.3,4.4,0.0,17.9,312358.3828125,2310.20960006097
49638,10017,10017,36061009400,152754,0,Census Tract 94,New York,New York County,50,54,50,50,0,50,0,0,0,0,0,0,0,0,4,0,0,0,0,4,4,7.4,0.0,,100.0,266474.40625,2308.9378622494396
49638,10173,10017,36061009400,152754,0,Census Tract 94,New York,New York County,50,54,50,50,0,50,0,0,0,0,0,0,0,0,4,0,0,0,0,4,4,7.4,0.0,,100.0,266474.40625,2308.9378622494396
49638,10177,10017,36061009400,152754,0,Census Tract 94,New York,New York County,50,54,50,50,0,50,0,0,0,0,0,0,0,0,4,0,0,0,0,4,4,7.4,0.0,,100.0,266474.40625,2308.9378622494396
49639,10001,10001,36061009500,171964,0,Census Tract 95,New York,New York County,1326,1969,1446,1350,18,1308,0,24,96,96,0,96,0,0,523,523,0,523,0,0,24,1.2,1.8,0.0,0.0,299915.515625,2277.34768844506
49640,10020,10019,36061009600,175330,0,Census Tract 96,New York,New York County,133,141,137,133,0,125,8,0,4,4,0,4,0,0,4,4,0,4,0,0,0,0.0,0.0,0.0,0.0,305869.78125,2310.36521907755
49640,10036,10036,36061009600,175330,0,Census Tract 96,New York,New York County,133,141,137,133,0,125,8,0,4,4,0,4,0,0,4,4,0,4,0,0,0,0.0,0.0,0.0,0.0,305869.78125,2310.36521907755
49640,10110,10036,36061009600,175330,0,Census Tract 96,New York,New York County,133,141,137,133,0,125,8,0,4,4,0,4,0,0,4,4,0,4,0,0,0,0.0,0.0,0.0,0.0,305869.78125,2310.36521907755
49641,10001,10001,36061009700,172933,0,Census Tract 97,New York,New York County,2444,4615,2728,2572,0,2319,125,128,156,156,0,156,0,0,1887,1309,0,1038,271,578,706,15.3,5.0,0.0,30.6,301627.54296875,2274.52226099475
49641,10199,10001,36061009700,172933,0,Census Tract 97,New York,New York County,2444,4615,2728,2572,0,2319,125,128,156,156,0,156,0,0,1887,1309,0,1038,271,578,706,15.3,5.0,0.0,30.6,301627.54296875,2274.52226099475
49642,10017,10017,36061009800,177068,0,Census Tract 98,New York,New York County,4767,6529,4891,4779,0,4767,0,12,112,112,0,112,0,0,1638,1376,0,1376,0,262,274,4.2,0.3,0.0,16.0,308895.25,2227.7974060720003
49642,10022,10022,36061009800,177068,0,Census Tract 98,New York,New York County,4767,6529,4891,4779,0,4767,0,12,112,112,0,112,0,0,1638,1376,0,1376,0,262,274,4.2,0.3,0.0,16.0,308895.25,2227.7974060720003
49643,10001,10001,36061009900,1002374,1130336,Census Tract 99,New York,New York County,4313,5337,4540,4331,0,4282,31,18,209,209,0,209,0,0,797,748,0,748,0,49,67,1.3,0.4,0.0,6.1,1756657.953125,14724.392151793701
49643,10011,10011,36061009900,1002374,1130336,Census Tract 99,New York,New York County,4313,5337,4540,4331,0,4282,31,18,209,209,0,209,0,0,797,748,0,748,0,49,67,1.3,0.4,0.0,6.1,1756657.953125,14724.392151793701
49643,10018,10018,36061009900,1002374,1130336,Census Tract 99,New York,New York County,4313,5337,4540,4331,0,4282,31,18,209,209,0,209,0,0,797,748,0,748,0,49,67,1.3,0.4,0.0,6.1,1756657.953125,14724.392151793701
49644,10017,10017,36061010000,172894,0,Census Tract 100,New York,New York County,1328,1634,1350,1328,0,1328,0,0,22,22,0,22,0,0,284,241,0,241,0,43,43,2.6,0.0,0.0,15.1,301637.41796875,2292.61831378271
49644,10022,10022,36061010000,172894,0,Census Tract 100,New York,New York County,1328,1634,1350,1328,0,1328,0,0,22,22,0,22,0,0,284,241,0,241,0,43,43,2.6,0.0,0.0,15.1,301637.41796875,2292.61831378271
49644,10152,10022,36061010000,172894,0,Census Tract 100,New York,New York County,1328,1634,1350,1328,0,1328,0,0,22,22,0,22,0,0,284,241,0,241,0,43,43,2.6,0.0,0.0,15.1,301637.41796875,2292.61831378271
49644,10154,10022,36061010000,172894,0,Census Tract 100,New York,New York County,1328,1634,1350,1328,0,1328,0,0,22,22,0,22,0,0,284,241,0,241,0,43,43,2.6,0.0,0.0,15.1,301637.41796875,2292.61831378271
49645,10001,10001,36061010100,175519,0,Census Tract 101,New York,New York County,889,1160,949,903,0,873,16,14,46,46,0,45,1,0,211,179,0,164,15,32,46,4.0,1.6,0.0,15.2,306137.4375,2292.31616589857
49645,10119,10001,36061010100,175519,0,Census Tract 101,New York,New York County,889,1160,949,903,0,873,16,14,46,46,0,45,1,0,211,179,0,164,15,32,46,4.0,1.6,0.0,15.2,306137.4375,2292.31616589857
49646,10022,10022,36061010200,172891,0,Census Tract 102,New York,New York County,52,70,52,52,0,48,4,0,0,0,0,0,0,0,18,15,0,15,0,3,3,4.3,0.0,,16.7,301643.0859375,2290.60356592261
49647,10001,10001,36061010300,174469,0,Census Tract 103,New York,New York County,1488,1875,1500,1495,0,1467,21,7,5,5,0,5,0,0,375,351,0,339,12,24,31,1.7,0.5,0.0,6.4,304326.91796875,2292.9634689337
49647,10199,10001,36061010300,174469,0,Census Tract 103,New York,New York County,1488,1875,1500,1495,0,1467,21,7,5,5,0,5,0,0,375,351,0,339,12,24,31,1.7,0.5,0.0,6.4,304326.91796875,2292.9634689337
49648,10019,10019,36061010400,173230,0,Census Tract 104,New York,New York County,599,869,626,599,0,549,50,0,27,21,0,21,0,6,243,196,0,180,16,47,53,6.1,0.0,22.2,19.3,302246.97265625,2292.85246611805
49648,10020,10019,36061010400,173230,0,Census Tract 104,New York,New York County,599,869,626,599,0,549,50,0,27,21,0,21,0,6,243,196,0,180,16,47,53,6.1,0.0,22.2,19.3,302246.97265625,2292.85246611805
49648,10103,10019,36061010400,173230,0,Census Tract 104,New York,New York County,599,869,626,599,0,549,50,0,27,21,0,21,0,6,243,196,0,180,16,47,53,6.1,0.0,22.2,19.3,302246.97265625,2292.85246611805
49648,10111,10019,36061010400,173230,0,Census Tract 104,New York,New York County,599,869,626,599,0,549,50,0,27,21,0,21,0,6,243,196,0,180,16,47,53,6.1,0.0,22.2,19.3,302246.97265625,2292.85246611805
49648,10112,10019,36061010400,173230,0,Census Tract 104,New York,New York County,599,869,626,599,0,549,50,0,27,21,0,21,0,6,243,196,0,180,16,47,53,6.1,0.0,22.2,19.3,302246.97265625,2292.85246611805
49649,10022,10022,36061010601,121208,130046,Census Tract 106.01,New York,New York County,3760,6794,3877,3783,0,3678,82,23,94,94,0,94,0,0,2917,2547,0,2330,217,370,393,5.8,0.6,0.0,12.7,232620.875,3204.84912046921
49650,10021,10021,36061010602,125711,73073,Census Tract 106.02,New York,New York County,2943,3767,2974,2943,0,2420,523,0,31,31,0,31,0,0,793,780,0,667,113,13,13,0.3,0.0,0.0,1.6,234333.98046875,2764.5149637170503
49650,10022,10022,36061010602,125711,73073,Census Tract 106.02,New York,New York County,2943,3767,2974,2943,0,2420,523,0,31,31,0,31,0,0,793,780,0,667,113,13,13,0.3,0.0,0.0,1.6,234333.98046875,2764.5149637170503
49650,10065,10065,36061010602,125711,73073,Census Tract 106.02,New York,New York County,2943,3767,2974,2943,0,2420,523,0,31,31,0,31,0,0,793,780,0,667,113,13,13,0.3,0.0,0.0,1.6,234333.98046875,2764.5149637170503
49651,10022,10022,36061010800,182589,0,Census Tract 108,New York,New York County,6005,7702,6307,6210,39,5871,95,205,97,97,0,97,0,0,1395,1370,16,1279,75,25,230,3.0,3.3,0.0,1.8,318556.03515625,2259.70986811247
49652,10001,10001,36061010900,175741,0,Census Tract 109,New York,New York County,138,156,141,138,0,138,0,0,3,3,0,3,0,0,15,15,0,15,0,0,0,0.0,0.0,0.0,0.0,306547.703125,2298.01151115807
49652,10018,10018,36061010900,175741,0,Census Tract 109,New York,New York County,138,156,141,138,0,138,0,0,3,3,0,3,0,0,15,15,0,15,0,0,0,0.0,0.0,0.0,0.0,306547.703125,2298.01151115807
49653,10022,10022,36061011000,176510,0,Census Tract 110,New York,New York County,4388,6140,4860,4623,0,4355,33,235,237,210,0,172,38,27,1280,1130,0,1104,26,150,412,6.7,5.1,11.4,11.7,307980.41796875,2223.44864075991
49653,10065,10065,36061011000,176510,0,Census Tract 110,New York,New York County,4388,6140,4860,4623,0,4355,33,235,237,210,0,172,38,27,1280,1130,0,1104,26,150,412,6.7,5.1,11.4,11.7,307980.41796875,2223.44864075991
49654,10001,10001,36061011100,175464,0,Census Tract 111,New York,New York County,3137,4530,3234,3175,0,3102,35,38,59,59,0,59,0,0,1296,965,0,936,29,331,369,8.1,1.2,0.0,25.5,306086.9140625,2293.13605374238
49654,10018,10018,36061011100,175464,0,Census Tract 111,New York,New York County,3137,4530,3234,3175,0,3102,35,38,59,59,0,59,0,0,1296,965,0,936,29,331,369,8.1,1.2,0.0,25.5,306086.9140625,2293.13605374238
49655,10019,10019,36061011201,79536,0,Census Tract 112.01,New York,New York County,537,772,550,537,0,496,41,0,13,13,0,13,0,0,222,209,0,192,17,13,13,1.7,0.0,0.0,5.9,138784.23046875,1496.16589452271
49656,10022,10022,36061011202,78008,0,Census Tract 112.02,New York,New York County,204,350,208,204,0,197,7,0,4,4,0,4,0,0,142,137,0,121,16,5,5,1.4,0.0,0.0,3.5,136113.01953125,1484.8088204170099
49656,10153,10022,36061011202,78008,0,Census Tract 112.02,New York,New York County,204,350,208,204,0,197,7,0,4,4,0,4,0,0,142,137,0,121,16,5,5,1.4,0.0,0.0,3.5,136113.01953125,1484.8088204170099
49657,10022,10022,36061011203,77947,0,Census Tract 112.03,New York,New York County,768,1049,808,777,0,746,22,9,31,31,0,31,0,0,241,241,0,228,13,0,9,0.9,1.2,0.0,0.0,136001.16015625,1484.06483472299
49658,10018,10018,36061011300,175653,0,Census Tract 113,New York,New York County,70,78,70,70,0,70,0,0,0,0,0,0,0,0,8,8,0,8,0,0,0,0.0,0.0,,0.0,306417.14453125,2294.09578101945
49658,10036,10036,36061011300,175653,0,Census Tract 113,New York,New York County,70,78,70,70,0,70,0,0,0,0,0,0,0,0,8,8,0,8,0,0,0,0.0,0.0,,0.0,306417.14453125,2294.09578101945
49659,10022,10022,36061011401,98508,0,Census Tract 114.01,New York,New York County,482,985,497,482,0,482,0,0,15,15,0,15,0,0,488,427,0,409,18,61,61,6.2,0.0,0.0,12.5,171893.71875,1657.92543299086
49659,10065,10065,36061011401,98508,0,Census Tract 114.01,New York,New York County,482,985,497,482,0,482,0,0,15,15,0,15,0,0,488,427,0,409,18,61,61,6.2,0.0,0.0,12.5,171893.71875,1657.92543299086
49660,10022,10022,36061011402,98799,0,Census Tract 114.02,New York,New York County,931,1563,990,940,18,904,9,9,50,50,0,50,0,0,573,532,0,451,81,41,50,3.2,1.0,0.0,7.2,172392.7734375,1660.95338876199
49660,10065,10065,36061011402,98799,0,Census Tract 114.02,New York,New York County,931,1563,990,940,18,904,9,9,50,50,0,50,0,0,573,532,0,451,81,41,50,3.2,1.0,0.0,7.2,172392.7734375,1660.95338876199
49661,10018,10018,36061011500,175588,0,Census Tract 115,New York,New York County,2384,3166,2580,2484,0,2340,44,100,96,96,0,96,0,0,586,539,0,526,13,47,147,4.6,4.0,0.0,8.0,306321.78515625,2294.04976380161
49661,10036,10036,36061011500,175588,0,Census Tract 115,New York,New York County,2384,3166,2580,2484,0,2340,44,100,96,96,0,96,0,0,586,539,0,526,13,47,147,4.6,4.0,0.0,8.0,306321.78515625,2294.04976380161
49662,10021,10021,36061011600,195582,132923,Census Tract 116,New York,New York County,2021,2683,2169,2085,0,1979,42,64,84,84,0,84,0,0,514,382,0,345,37,132,196,7.3,3.1,0.0,25.7,382464.4375,3630.84920773192
49662,10065,10065,36061011600,195582,132923,Census Tract 116,New York,New York County,2021,2683,2169,2085,0,1979,42,64,84,84,0,84,0,0,514,382,0,345,37,132,196,7.3,3.1,0.0,25.7,382464.4375,3630.84920773192
49663,10018,10018,36061011700,187347,176830,Census Tract 117,New York,New York County,3119,3733,3249,3119,0,3065,54,0,130,130,0,130,0,0,484,438,36,340,62,46,46,1.2,0.0,0.0,9.5,338352.11328125,3409.79756555104
49663,10036,10036,36061011700,187347,176830,Census Tract 117,New York,New York County,3119,3733,3249,3119,0,3065,54,0,130,130,0,130,0,0,484,438,36,340,62,46,46,1.2,0.0,0.0,9.5,338352.11328125,3409.79756555104
49664,10021,10021,36061011800,176768,0,Census Tract 118,New York,New York County,5117,7692,5174,5117,0,5087,30,0,57,57,0,57,0,0,2518,2276,0,2233,43,242,242,3.1,0.0,0.0,9.6,308461.3984375,2224.16231281411
49664,10065,10065,36061011800,176768,0,Census Tract 118,New York,New York County,5117,7692,5174,5117,0,5087,30,0,57,57,0,57,0,0,2518,2276,0,2233,43,242,242,3.1,0.0,0.0,9.6,308461.3984375,2224.16231281411
49665,10036,10036,36061011900,177591,0,Census Tract 119,New York,New York County,268,1065,393,354,0,199,69,86,39,29,0,0,29,10,672,330,0,211,119,342,438,41.1,24.3,25.6,50.9,309820.83984375,2303.06857363903
49666,10021,10021,36061012000,173024,0,Census Tract 120,New York,New York County,1446,2614,1460,1446,0,1405,41,0,14,14,0,14,0,0,1154,1070,0,1056,14,84,84,3.2,0.0,0.0,7.3,301942.6015625,2291.73798719896
49666,10065,10065,36061012000,173024,0,Census Tract 120,New York,New York County,1446,2614,1460,1446,0,1405,41,0,14,14,0,14,0,0,1154,1070,0,1056,14,84,84,3.2,0.0,0.0,7.3,301942.6015625,2291.73798719896
49667,10036,10036,36061012100,178159,0,Census Tract 121,New York,New York County,5145,7247,5619,5145,0,4564,581,0,474,452,0,428,24,22,1628,1102,0,1070,32,526,548,7.6,0.0,4.6,32.3,310834.13671875,2306.13126820087
49668,10021,10021,36061012200,172616,0,Census Tract 122,New York,New York County,1084,2298,1120,1095,0,1084,0,11,25,25,0,25,0,0,1178,1125,16,1049,60,53,64,2.8,1.0,0.0,4.5,301242.98828125,2289.76588664673
49668,10065,10065,36061012200,172616,0,Census Tract 122,New York,New York County,1084,2298,1120,1095,0,1084,0,11,25,25,0,25,0,0,1178,1125,16,1049,60,53,64,2.8,1.0,0.0,4.5,301242.98828125,2289.76588664673
49669,10021,10021,36061012400,171580,75103,Census Tract 124,New York,New York County,5780,7595,6038,5886,0,5780,0,106,152,152,0,132,20,0,1557,1335,0,1335,0,222,328,4.3,1.8,0.0,14.3,327464.9296875,3305.5368518237296
49670,10019,10019,36061012500,174253,0,Census Tract 125,New York,New York County,1873,2315,1926,1873,7,1817,49,0,53,53,0,27,26,0,389,314,8,279,27,75,75,3.2,0.0,0.0,19.3,304022.65234375,2287.87798575399
49670,10020,10019,36061012500,174253,0,Census Tract 125,New York,New York County,1873,2315,1926,1873,7,1817,49,0,53,53,0,27,26,0,389,314,8,279,27,75,75,3.2,0.0,0.0,19.3,304022.65234375,2287.87798575399
49670,10036,10036,36061012500,174253,0,Census Tract 125,New York,New York County,1873,2315,1926,1873,7,1817,49,0,53,53,0,27,26,0,389,314,8,279,27,75,75,3.2,0.0,0.0,19.3,304022.65234375,2287.87798575399
49671,10021,10021,36061012600,183653,0,Census Tract 126,New York,New York County,7466,11201,7715,7566,0,7066,400,100,149,149,0,149,0,0,3486,3446,0,3410,36,40,140,1.2,1.3,0.0,1.1,320505.81640625,2265.92618162219
49672,10019,10019,36061012700,174028,0,Census Tract 127,New York,New York County,5063,6176,5226,5101,0,4811,252,38,125,125,0,125,0,0,950,567,0,471,96,383,421,6.8,0.7,0.0,40.3,303650.2421875,2286.9635123214002
49672,10036,10036,36061012700,174028,0,Census Tract 127,New York,New York County,5063,6176,5226,5101,0,4811,252,38,125,125,0,125,0,0,950,567,0,471,96,383,421,6.8,0.7,0.0,40.3,303650.2421875,2286.9635123214002
49673,10021,10021,36061012800,178790,0,Census Tract 128,New York,New York County,2554,4738,2699,2595,0,2537,17,41,104,104,0,104,0,0,2039,1955,18,1937,0,84,125,2.6,1.6,0.0,4.1,312045.65234375,2342.04415712158
49673,10075,10075,36061012800,178790,0,Census Tract 128,New York,New York County,2554,4738,2699,2595,0,2537,17,41,104,104,0,104,0,0,2039,1955,18,1937,0,84,125,2.6,1.6,0.0,4.1,312045.65234375,2342.04415712158
49674,10019,10019,36061012900,426844,384608,Census Tract 129,New York,New York County,5212,6585,5484,5318,0,5048,164,106,166,166,0,166,0,0,1101,1064,0,1025,39,37,143,2.2,2.0,0.0,3.4,704847.36328125,6623.97279046406
49674,10036,10036,36061012900,426844,384608,Census Tract 129,New York,New York County,5212,6585,5484,5318,0,5048,164,106,166,166,0,166,0,0,1101,1064,0,1025,39,37,143,2.2,2.0,0.0,3.4,704847.36328125,6623.97279046406
49675,10021,10021,36061013000,178226,0,Census Tract 130,New York,New York County,1754,3121,1851,1754,0,1574,180,0,97,97,0,97,0,0,1270,1187,0,1187,0,83,83,2.7,0.0,0.0,6.5,311072.44140625,2339.64581340113
49675,10075,10075,36061013000,178226,0,Census Tract 130,New York,New York County,1754,3121,1851,1754,0,1574,180,0,97,97,0,97,0,0,1270,1187,0,1187,0,83,83,2.7,0.0,0.0,6.5,311072.44140625,2339.64581340113
49676,10019,10019,36061013100,174135,0,Census Tract 131,New York,New York County,1944,2579,1996,1952,0,1831,113,8,44,44,0,44,0,0,583,421,8,403,10,162,170,6.6,0.4,0.0,27.8,303839.625,2286.49109768458
49677,10021,10021,36061013200,200886,92937,Census Tract 132,New York,New York County,7066,9042,7066,7066,0,7066,0,0,0,0,0,0,0,0,1976,1829,0,1774,55,147,147,1.6,0.0,,7.4,380236.37890625,3399.56956438858
49677,10075,10075,36061013200,200886,92937,Census Tract 132,New York,New York County,7066,9042,7066,7066,0,7066,0,0,0,0,0,0,0,0,1976,1829,0,1774,55,147,147,1.6,0.0,,7.4,380236.37890625,3399.56956438858
49677,10162,10075,36061013200,200886,92937,Census Tract 132,New York,New York County,7066,9042,7066,7066,0,7066,0,0,0,0,0,0,0,0,1976,1829,0,1774,55,147,147,1.6,0.0,,7.4,380236.37890625,3399.56956438858
49678,10019,10019,36061013300,174355,0,Census Tract 133,New York,New York County,3734,5331,3993,3834,0,3608,126,100,159,159,0,151,8,0,1338,1122,0,942,180,216,316,5.9,2.6,0.0,16.1,304243.6953125,2288.0717426593
49679,10021,10021,36061013400,181779,0,Census Tract 134,New York,New York County,7544,10206,7740,7688,0,7359,185,144,52,52,0,0,52,0,2466,2229,0,2142,87,237,381,3.7,1.9,0.0,9.6,317263.10546875,2255.86661602025
49679,10075,10075,36061013400,181779,0,Census Tract 134,New York,New York County,7544,10206,7740,7688,0,7359,185,144,52,52,0,0,52,0,2466,2229,0,2142,87,237,381,3.7,1.9,0.0,9.6,317263.10546875,2255.86661602025
49680,10019,10019,36061013500,432329,401587,Census Tract 135,New York,New York County,4580,7422,5022,4666,0,4477,103,86,356,356,0,356,0,0,2400,1880,0,1720,160,520,606,8.2,1.8,0.0,21.7,735167.58984375,8088.064088514391
49681,10028,10028,36061013600,219496,111000,Census Tract 136,New York,New York County,9993,13961,10185,9993,0,9727,266,0,192,192,0,192,0,0,3776,3476,0,3189,287,300,300,2.1,0.0,0.0,7.9,386216.9609375,2576.2476508914497
49681,10075,10075,36061013600,219496,111000,Census Tract 136,New York,New York County,9993,13961,10185,9993,0,9727,266,0,192,192,0,192,0,0,3776,3476,0,3189,287,300,300,2.1,0.0,0.0,7.9,386216.9609375,2576.2476508914497
49682,10019,10019,36061013700,226356,0,Census Tract 137,New York,New York County,3839,5635,4010,3839,0,3734,105,0,171,171,0,171,0,0,1625,1522,0,1416,106,103,103,1.8,0.0,0.0,6.3,394987.359375,2519.98314455236
49683,10028,10028,36061013800,182091,0,Census Tract 138,New York,New York County,8429,10447,8808,8525,0,8297,132,96,283,283,0,226,57,0,1639,1424,0,1328,96,215,311,3.0,1.1,0.0,13.1,317839.5859375,2255.89005633873
49683,10075,10075,36061013800,182091,0,Census Tract 138,New York,New York County,8429,10447,8808,8525,0,8297,132,96,283,283,0,226,57,0,1639,1424,0,1328,96,215,311,3.0,1.1,0.0,13.1,317839.5859375,2255.89005633873
49684,10019,10019,36061013900,181605,0,Census Tract 139,New York,New York County,7086,9869,7680,7128,49,6726,311,42,552,552,0,552,0,0,2189,1895,0,1304,591,294,336,3.4,0.6,0.0,13.4,316918.8515625,2322.73168928397
49685,10028,10028,36061014000,179108,0,Census Tract 140,New York,New York County,4212,6386,4311,4212,0,4064,148,0,99,99,0,85,14,0,2075,1930,32,1818,80,145,145,2.3,0.0,0.0,7.0,312641.13671875,2344.75702892367
49685,10075,10075,36061014000,179108,0,Census Tract 140,New York,New York County,4212,6386,4311,4212,0,4064,148,0,99,99,0,85,14,0,2075,1930,32,1818,80,145,145,2.3,0.0,0.0,7.0,312641.13671875,2344.75702892367
49686,10028,10028,36061014200,178987,0,Census Tract 142,New York,New York County,2264,3868,2314,2264,0,2230,34,0,50,50,0,50,0,0,1554,1258,0,1225,33,296,296,7.7,0.0,0.0,19.0,312441.01171875,2347.0024421191
49686,10075,10075,36061014200,178987,0,Census Tract 142,New York,New York County,2264,3868,2314,2264,0,2230,34,0,50,50,0,50,0,0,1554,1258,0,1225,33,296,296,7.7,0.0,0.0,19.0,312441.01171875,2347.0024421191
49688,10028,10028,36061014401,74319,0,Census Tract 144.01,New York,New York County,3123,4400,3287,3132,0,2835,288,9,155,155,0,155,0,0,1113,1061,0,940,121,52,61,1.4,0.3,0.0,4.7,129723.75,1616.0157640209698
49689,10028,10028,36061014402,176863,0,Census Tract 144.02,New York,New York County,4091,6003,4293,4124,0,4009,82,33,169,169,0,169,0,0,1710,1673,16,1638,19,37,70,1.2,0.8,0.0,2.2,301928.68359375,2793.4556925232105
49689,10128,10128,36061014402,176863,0,Census Tract 144.02,New York,New York County,4091,6003,4293,4124,0,4009,82,33,169,169,0,169,0,0,1710,1673,16,1638,19,37,70,1.2,0.8,0.0,2.2,301928.68359375,2793.4556925232105
49690,10019,10019,36061014500,177125,0,Census Tract 145,New York,New York County,2788,4464,2982,2803,0,2743,45,15,179,179,0,179,0,0,1482,1436,0,1364,72,46,61,1.4,0.5,0.0,3.1,309122.703125,2360.70912508673
49690,10023,10023,36061014500,177125,0,Census Tract 145,New York,New York County,2788,4464,2982,2803,0,2743,45,15,179,179,0,179,0,0,1482,1436,0,1364,72,46,61,1.4,0.5,0.0,3.1,309122.703125,2360.70912508673
49691,10028,10028,36061014601,74328,0,Census Tract 146.01,New York,New York County,3196,3989,3258,3242,0,3196,0,46,16,16,0,16,0,0,731,695,0,666,29,36,82,2.1,1.4,0.0,4.9,129747.37109375,1616.3349900679502
49692,10028,10028,36061014602,109193,0,Census Tract 146.02,New York,New York County,4860,6502,5134,4860,0,4678,182,0,274,274,0,250,24,0,1368,1269,0,1269,0,99,99,1.5,0.0,0.0,7.2,190617.171875,1823.2607133217002
49692,10128,10128,36061014602,109193,0,Census Tract 146.02,New York,New York County,4860,6502,5134,4860,0,4678,182,0,274,274,0,250,24,0,1368,1269,0,1269,0,99,99,1.5,0.0,0.0,7.2,190617.171875,1823.2607133217002
49693,10019,10019,36061014700,65414,0,Census Tract 147,New York,New York County,2312,2834,2398,2312,0,2273,39,0,86,86,0,86,0,0,436,393,0,369,24,43,43,1.5,0.0,0.0,9.9,114168.859375,1355.8333196378
49693,10023,10023,36061014700,65414,0,Census Tract 147,New York,New York County,2312,2834,2398,2312,0,2273,39,0,86,86,0,86,0,0,436,393,0,369,24,43,43,1.5,0.0,0.0,9.9,114168.859375,1355.8333196378
49694,10028,10028,36061014801,51979,0,Census Tract 148.01,New York,New York County,1730,2564,1799,1730,0,1698,32,0,69,69,0,69,0,0,765,727,35,658,34,38,38,1.5,0.0,0.0,5.0,90739.92578125,1263.01057060584
49695,10128,10128,36061014802,125620,0,Census Tract 148.02,New York,New York County,3984,5880,4232,4104,0,3815,169,120,128,128,0,128,0,0,1648,1613,0,1596,17,35,155,2.6,2.9,0.0,2.1,219311.7421875,1889.9377933779601
49696,10023,10023,36061014900,174047,0,Census Tract 149,New York,New York County,2862,4265,2892,2875,0,2814,48,13,17,17,0,17,0,0,1373,1274,0,1245,29,99,112,2.6,0.5,0.0,7.2,303773.59375,2290.00782261603
49697,10028,10028,36061015001,51643,0,Census Tract 150.01,New York,New York County,984,1731,1033,1006,0,984,0,22,27,27,0,21,6,0,698,666,0,660,6,32,54,3.1,2.2,0.0,4.6,90155.25390625,1257.35906436741
49698,10028,10028,36061015002,125571,0,Census Tract 150.02,New York,New York County,2459,4315,2533,2459,0,2452,7,0,74,74,0,74,0,0,1782,1733,0,1733,0,49,49,1.1,0.0,0.0,2.7,219231.57421875,1889.1177793599697
49698,10128,10128,36061015002,125571,0,Census Tract 150.02,New York,New York County,2459,4315,2533,2459,0,2452,7,0,74,74,0,74,0,0,1782,1733,0,1733,0,49,49,1.1,0.0,0.0,2.7,219231.57421875,1889.1177793599697
49699,10019,10019,36061015100,333044,306023,Census Tract 151,New York,New York County,4260,7783,4598,4398,0,3900,360,138,200,200,0,200,0,0,3185,2501,0,2151,350,684,822,10.6,3.1,0.0,21.5,610349.26171875,5171.17555742935
49699,10023,10023,36061015100,333044,306023,Census Tract 151,New York,New York County,4260,7783,4598,4398,0,3900,360,138,200,200,0,200,0,0,3185,2501,0,2151,350,684,822,10.6,3.1,0.0,21.5,610349.26171875,5171.17555742935
49699,10069,10069,36061015100,333044,306023,Census Tract 151,New York,New York County,4260,7783,4598,4398,0,3900,360,138,200,200,0,200,0,0,3185,2501,0,2151,350,684,822,10.6,3.1,0.0,21.5,610349.26171875,5171.17555742935
49700,10128,10128,36061015200,189340,529192,Census Tract 152,New York,New York County,3841,6169,4078,3877,0,3566,275,36,201,122,0,78,44,79,2091,1452,27,1152,273,639,754,12.2,0.9,39.3,30.6,389147.02734375,5867.682894098771
49701,10023,10023,36061015300,174116,0,Census Tract 153,New York,New York County,5655,8528,5817,5702,0,5627,28,47,115,115,0,115,0,0,2711,2232,0,2054,178,479,526,6.2,0.8,0.0,17.7,303920.890625,2284.47456882307
49702,10128,10128,36061015400,177371,0,Census Tract 154,New York,New York County,8469,12227,8999,8694,159,7694,616,225,305,305,0,305,0,0,3228,2891,0,2051,840,337,562,4.6,2.6,0.0,10.4,309660.265625,2229.85066883057
49703,10023,10023,36061015500,197390,214654,Census Tract 155,New York,New York County,5706,8677,5955,5706,0,5602,104,0,249,249,0,249,0,0,2722,2555,0,2447,108,167,167,1.9,0.0,0.0,6.1,352133.1953125,3594.2597709557103
49703,10069,10069,36061015500,197390,214654,Census Tract 155,New York,New York County,5706,8677,5955,5706,0,5602,104,0,249,249,0,249,0,0,2722,2555,0,2447,108,167,167,1.9,0.0,0.0,6.1,352133.1953125,3594.2597709557103
49704,10128,10128,36061015601,73566,0,Census Tract 156.01,New York,New York County,3772,4683,3883,3802,0,3616,156,30,81,81,0,81,0,0,800,642,0,573,69,158,188,4.0,0.8,0.0,19.8,128443.5625,1612.20296987711
49705,10029,10029,36061015602,108755,0,Census Tract 156.02,New York,New York County,1193,2039,1259,1211,0,1142,51,18,48,48,0,48,0,0,780,632,0,570,62,148,166,8.1,1.5,0.0,19.0,189891.2109375,1821.9984309817498
49705,10128,10128,36061015602,108755,0,Census Tract 156.02,New York,New York County,1193,2039,1259,1211,0,1142,51,18,48,48,0,48,0,0,780,632,0,570,62,148,166,8.1,1.5,0.0,19.0,189891.2109375,1821.9984309817498
49706,10023,10023,36061015700,182396,0,Census Tract 157,New York,New York County,6002,7965,6381,6002,0,5914,88,0,379,379,0,379,0,0,1584,1330,0,1330,0,254,254,3.2,0.0,0.0,16.0,318395.69140625,2326.86034750196
49707,10128,10128,36061015801,125754,0,Census Tract 158.01,New York,New York County,2988,4145,3100,2988,0,2959,29,0,112,112,0,99,13,0,1045,1014,0,862,152,31,31,0.7,0.0,0.0,3.0,219565.609375,1890.35175691525
49708,10029,10029,36061015802,51510,0,Census Tract 158.02,New York,New York County,2262,3041,2399,2262,0,2167,95,0,137,137,0,90,47,0,642,621,0,587,34,21,21,0.7,0.0,0.0,3.3,89940.27734375,1259.7977198825
49708,10128,10128,36061015802,51510,0,Census Tract 158.02,New York,New York County,2262,3041,2399,2262,0,2167,95,0,137,137,0,90,47,0,642,621,0,587,34,21,21,0.7,0.0,0.0,3.3,89940.27734375,1259.7977198825
49709,10023,10023,36061015900,175127,110770,Census Tract 159,New York,New York County,5707,8225,5920,5735,0,5691,16,28,185,185,0,185,0,0,2305,2087,0,2087,0,218,246,3.0,0.5,0.0,9.5,305728.90625,2623.22222676073
49709,10069,10069,36061015900,175127,110770,Census Tract 159,New York,New York County,5707,8225,5920,5735,0,5691,16,28,185,185,0,185,0,0,2305,2087,0,2087,0,218,246,3.0,0.5,0.0,9.5,305728.90625,2623.22222676073
49710,10128,10128,36061016001,125615,0,Census Tract 160.01,New York,New York County,1766,3179,1828,1784,0,1743,23,18,44,44,0,44,0,0,1351,1344,0,1316,28,7,25,0.8,1.0,0.0,0.5,219331.70703125,1892.78446308235
49711,10029,10029,36061016002,51424,0,Census Tract 160.02,New York,New York County,1411,2469,1495,1439,0,1411,0,28,56,56,0,56,0,0,974,954,0,727,227,20,48,1.9,1.9,0.0,2.1,89795.5,1256.9076824717401
49712,10023,10023,36061016100,155741,0,Census Tract 161,New York,New York County,3953,5408,4218,3965,0,3848,105,12,253,253,0,253,0,0,1190,1072,13,1032,27,118,130,2.4,0.3,0.0,9.9,271886.4375,2303.61458702779
49712,10024,10024,36061016100,155741,0,Census Tract 161,New York,New York County,3953,5408,4218,3965,0,3848,105,12,253,253,0,253,0,0,1190,1072,13,1032,27,118,130,2.4,0.3,0.0,9.9,271886.4375,2303.61458702779
49713,10029,10029,36061016200,272018,832556,Census Tract 162,New York,New York County,3797,8177,4692,4120,15,3592,190,323,572,456,0,261,195,116,3485,2451,0,2063,388,1034,1473,18.0,7.8,20.3,29.7,554636.94921875,6321.8647272137905
49714,10023,10023,36061016300,263616,352996,Census Tract 163,New York,New York County,3949,5856,4170,3968,0,3780,169,19,202,202,0,187,15,0,1686,1451,0,1368,83,235,254,4.3,0.5,0.0,13.9,460250.1171875,3283.1834327730603
49714,10024,10024,36061016300,263616,352996,Census Tract 163,New York,New York County,3949,5856,4170,3968,0,3780,169,19,202,202,0,187,15,0,1686,1451,0,1368,83,235,254,4.3,0.5,0.0,13.9,460250.1171875,3283.1834327730603
49715,10029,10029,36061016400,177390,0,Census Tract 164,New York,New York County,2528,6103,3190,2684,0,2394,134,156,506,380,0,380,0,126,2913,2269,0,1993,276,644,926,15.2,5.8,24.9,22.1,309748.31640625,2229.50836185053
49716,10024,10024,36061016500,204317,0,Census Tract 165,New York,New York County,3756,5408,3978,3863,0,3756,0,107,115,115,0,115,0,0,1430,1299,0,1286,13,131,238,4.4,2.8,0.0,9.2,356714.65234375,2534.4571623344395
49717,10029,10029,36061016600,174218,0,Census Tract 166,New York,New York County,3346,5340,3593,3423,0,3095,251,77,170,170,0,170,0,0,1747,1322,0,1088,234,425,502,9.4,2.2,0.0,24.3,304230.65234375,2300.26659502407
49718,10024,10024,36061016700,196978,141457,Census Tract 167,New York,New York County,3710,5126,3865,3736,0,3597,113,26,129,129,0,129,0,0,1261,1194,17,1163,14,67,93,1.8,0.7,0.0,5.3,343930.15234375,2616.6410743690303
49719,10029,10029,36061016800,199278,0,Census Tract 168,New York,New York County,1324,3179,1646,1416,0,1219,105,92,230,168,0,168,0,62,1533,1047,0,919,128,486,640,20.1,6.5,27.0,31.7,348006.83203125,2523.8873355247197
49720,10024,10024,36061016900,180002,0,Census Tract 169,New York,New York County,5044,6954,5115,5072,0,5044,0,28,43,43,0,43,0,0,1839,1694,0,1634,60,145,173,2.5,0.6,0.0,7.9,314290.7734375,2316.4834099754003
49721,10029,10029,36061017000,182917,0,Census Tract 170,New York,New York County,3207,6466,3672,3447,0,3094,113,240,225,207,0,207,0,18,2794,1762,17,1645,100,1032,1290,20.0,7.0,8.0,36.9,319433.16796875,2263.05830453031
49722,10024,10024,36061017100,217834,194050,Census Tract 171,New York,New York County,5405,7543,5608,5430,0,5330,75,25,178,178,0,178,0,0,1935,1780,0,1677,103,155,180,2.4,0.5,0.0,8.0,380378.37109375,2618.8743383469
49723,10029,10029,36061017200,177939,0,Census Tract 172,New York,New York County,2150,4809,2918,2427,0,2011,139,277,491,491,0,475,16,0,1891,1284,0,1251,33,607,884,18.4,11.4,0.0,32.1,310767.71875,2335.97420881903
49724,10024,10024,36061017300,178602,0,Census Tract 173,New York,New York County,5131,7594,5301,5161,0,5012,119,30,140,140,0,140,0,0,2293,2047,0,1347,700,246,276,3.6,0.6,0.0,10.7,311869.41796875,2309.73903320517
49725,10029,10029,36061017401,100812,0,Census Tract 174.01,New York,New York County,1308,3378,1616,1434,0,1147,161,126,182,182,0,182,0,0,1762,1314,0,969,345,448,574,17.0,8.8,0.0,25.4,176074.28125,1688.93314883325
49726,10029,10029,36061017402,50730,0,Census Tract 174.02,New York,New York County,1106,2064,1259,1157,0,1014,92,51,102,102,0,81,21,0,805,645,0,495,150,160,211,10.2,4.4,0.0,19.9,88608.65625,1246.96466763644
49727,10024,10024,36061017500,216905,192184,Census Tract 175,New York,New York County,6147,8248,6186,6147,0,5857,290,0,39,39,0,39,0,0,2062,1850,28,1691,131,212,212,2.6,0.0,0.0,10.3,378748.46484375,2621.62593718543
49728,10024,10024,36061017700,174561,0,Census Tract 177,New York,New York County,5022,8005,5429,5176,0,4855,167,154,253,253,0,184,69,0,2576,2193,0,2020,173,383,537,6.7,3.0,0.0,14.9,304836.38671875,2289.77398508409
49728,10025,10025,36061017700,174561,0,Census Tract 177,New York,New York County,5022,8005,5429,5176,0,4855,167,154,253,253,0,184,69,0,2576,2193,0,2020,173,383,537,6.7,3.0,0.0,14.9,304836.38671875,2289.77398508409
49729,10029,10029,36061017800,248851,209809,Census Tract 178,New York,New York County,1894,3192,2056,1985,0,1777,117,91,71,71,0,64,7,0,1136,852,0,724,128,284,375,11.7,4.6,0.0,25.0,474850.9375,4180.2643936821205
49729,10035,10035,36061017800,248851,209809,Census Tract 178,New York,New York County,1894,3192,2056,1985,0,1777,117,91,71,71,0,64,7,0,1136,852,0,724,128,284,375,11.7,4.6,0.0,25.0,474850.9375,4180.2643936821205
49730,10024,10024,36061017900,213916,191036,Census Tract 179,New York,New York County,4948,7807,5392,5043,0,4796,152,95,349,349,0,349,0,0,2415,2159,0,1774,385,256,351,4.5,1.9,0.0,10.6,373591.5625,2621.97149646442
49730,10025,10025,36061017900,213916,191036,Census Tract 179,New York,New York County,4948,7807,5392,5043,0,4796,152,95,349,349,0,349,0,0,2415,2159,0,1774,385,256,351,4.5,1.9,0.0,10.6,373591.5625,2621.97149646442
49731,10029,10029,36061018000,212522,0,Census Tract 180,New York,New York County,3248,6518,3967,3536,67,2978,203,288,431,322,0,278,44,109,2551,2197,0,1746,451,354,751,11.5,8.1,25.3,13.9,371168.359375,2439.50770222824
49732,10025,10025,36061018100,138455,0,Census Tract 181,New York,New York County,4591,8238,5039,4591,0,4519,72,0,448,382,0,382,0,66,3199,2769,52,2499,218,430,496,6.0,0.0,14.7,13.4,241800.6796875,2115.7553292355396
49733,10029,10029,36061018200,176900,0,Census Tract 182,New York,New York County,2848,6744,3347,3042,0,2577,271,194,305,271,0,271,0,34,3397,2981,0,2708,273,416,644,9.5,6.4,11.1,12.2,308994.66015625,2325.42739629764
49733,10035,10035,36061018200,176900,0,Census Tract 182,New York,New York County,2848,6744,3347,3042,0,2577,271,194,305,271,0,271,0,34,3397,2981,0,2708,273,416,644,9.5,6.4,11.1,12.2,308994.66015625,2325.42739629764
49734,10024,10024,36061018300,224312,187898,Census Tract 183,New York,New York County,4514,6100,4643,4514,0,4514,0,0,129,129,0,129,0,0,1457,1105,0,1046,59,352,352,5.8,0.0,0.0,24.2,391776.4296875,2660.16746198966
49734,10025,10025,36061018300,224312,187898,Census Tract 183,New York,New York County,4514,6100,4643,4514,0,4514,0,0,129,129,0,129,0,0,1457,1105,0,1046,59,352,352,5.8,0.0,0.0,24.2,391776.4296875,2660.16746198966
49735,10029,10029,36061018400,176580,0,Census Tract 184,New York,New York County,2331,6127,2723,2415,0,2259,72,84,308,213,0,213,0,95,3404,2212,0,1958,254,1192,1371,22.4,3.5,30.8,35.0,308446.57421875,2324.4381233060603
49735,10035,10035,36061018400,176580,0,Census Tract 184,New York,New York County,2331,6127,2723,2415,0,2259,72,84,308,213,0,213,0,95,3404,2212,0,1958,254,1192,1371,22.4,3.5,30.8,35.0,308446.57421875,2324.4381233060603
49736,10025,10025,36061018500,130383,0,Census Tract 185,New York,New York County,2859,4122,2968,2889,0,2802,57,30,79,79,0,79,0,0,1154,1055,0,1002,53,99,129,3.1,1.0,0.0,8.6,227718.87109375,2077.25213803282
49737,10026,10026,36061018600,121738,0,Census Tract 186,New York,New York County,2175,5266,2650,2427,0,1986,189,252,223,223,0,223,0,0,2616,1972,0,1748,224,644,896,17.0,10.4,0.0,24.6,212650.52734375,1857.7944835456
49738,10024,10024,36061018700,218107,184467,Census Tract 187,New York,New York County,4420,6978,5034,4626,50,4345,25,206,408,408,0,408,0,0,1944,1794,106,1585,103,150,356,5.1,4.5,0.0,7.7,381433.12890625,2653.1506236217897
49738,10025,10025,36061018700,218107,184467,Census Tract 187,New York,New York County,4420,6978,5034,4626,50,4345,25,206,408,408,0,408,0,0,1944,1794,106,1585,103,150,356,5.1,4.5,0.0,7.7,381433.12890625,2653.1506236217897
49739,10029,10029,36061018800,148532,0,Census Tract 188,New York,New York County,2502,4459,2880,2638,0,2371,131,136,242,224,0,224,0,18,1579,1011,21,728,262,568,722,16.2,5.2,7.4,36.0,259437.15234375,2056.9068370769396
49739,10035,10035,36061018800,148532,0,Census Tract 188,New York,New York County,2502,4459,2880,2638,0,2371,131,136,242,224,0,224,0,18,1579,1011,21,728,262,568,722,16.2,5.2,7.4,36.0,259437.15234375,2056.9068370769396
49740,10025,10025,36061018900,265399,0,Census Tract 189,New York,New York County,4475,9200,5409,4734,0,3951,524,259,675,514,33,307,174,161,3791,2876,0,2247,629,915,1335,14.5,5.5,23.9,24.1,463564.8359375,2728.74265857498
49741,10026,10026,36061019000,103802,0,Census Tract 190,New York,New York County,1682,2768,1897,1809,0,1624,58,127,88,88,0,88,0,0,871,664,0,630,34,207,334,12.1,7.0,0.0,23.8,181332.5625,1704.8113905069001
49742,10024,10024,36061019100,223476,175654,Census Tract 191,New York,New York County,5213,8293,5597,5240,0,5008,205,27,357,357,0,357,0,0,2696,2402,0,2265,137,294,321,3.9,0.5,0.0,10.9,390374.35546875,2672.23380030994
49742,10025,10025,36061019100,223476,175654,Census Tract 191,New York,New York County,5213,8293,5597,5240,0,5008,205,27,357,357,0,357,0,0,2696,2402,0,2265,137,294,321,3.9,0.5,0.0,10.9,390374.35546875,2672.23380030994
49743,10035,10035,36061019200,189854,175645,Census Tract 192,New York,New York County,1065,3074,1491,1263,0,1040,25,198,228,205,0,191,14,23,1583,1060,0,906,154,523,744,24.2,15.7,10.1,33.0,354448.23828125,3487.82826418433
49744,10025,10025,36061019300,175716,0,Census Tract 193,New York,New York County,4243,8364,4785,4474,0,3842,401,231,311,311,0,311,0,0,3579,2557,0,2055,502,1022,1253,15.0,5.2,0.0,28.6,306946.890625,2296.4551186459
49744,10026,10026,36061019300,175716,0,Census Tract 193,New York,New York County,4243,8364,4785,4474,0,3842,401,231,311,311,0,311,0,0,3579,2557,0,2055,502,1022,1253,15.0,5.2,0.0,28.6,306946.890625,2296.4551186459
49745,10035,10035,36061019400,175052,0,Census Tract 194,New York,New York County,1711,4874,2224,2203,18,1409,284,492,21,0,0,0,0,21,2650,1710,17,1267,426,940,1453,29.8,22.3,100.0,35.5,305786.9765625,2219.76208419452
49746,10024,10024,36061019500,218436,166301,Census Tract 195,New York,New York County,3946,6243,4188,3968,0,3849,97,22,220,174,0,174,0,46,2055,1890,0,1764,126,165,233,3.7,0.6,20.9,8.0,381600.72265625,2653.19198935051
49746,10025,10025,36061019500,218436,166301,Census Tract 195,New York,New York County,3946,6243,4188,3968,0,3849,97,22,220,174,0,174,0,46,2055,1890,0,1764,126,165,233,3.7,0.6,20.9,8.0,381600.72265625,2653.19198935051
49747,10035,10035,36061019600,177186,0,Census Tract 196,New York,New York County,1068,2947,1415,1306,0,1042,26,238,109,52,0,52,0,57,1532,853,6,736,111,679,974,33.1,18.2,52.3,44.3,309539.61328125,2329.35696801731
49748,10025,10025,36061019701,235976,0,Census Tract 197.01,New York,New York County,256,443,306,271,0,250,6,15,35,35,0,16,19,0,137,137,0,121,16,0,15,3.4,5.5,0.0,0.0,412269.5234375,4139.67604293493
49748,10026,10026,36061019701,235976,0,Census Tract 197.01,New York,New York County,256,443,306,271,0,250,6,15,35,35,0,16,19,0,137,137,0,121,16,0,15,3.4,5.5,0.0,0.0,412269.5234375,4139.67604293493
49749,10026,10026,36061019702,47396,0,Census Tract 197.02,New York,New York County,1334,2408,1601,1519,0,1263,71,185,82,82,0,31,51,0,807,600,0,530,70,207,392,16.3,12.2,0.0,25.7,82796.0390625,1296.1889934780802
49750,10035,10035,36061019800,225452,0,Census Tract 198,New York,New York County,1272,2328,1461,1337,0,1244,28,65,124,124,24,89,11,0,867,569,15,528,26,298,363,15.6,4.9,0.0,34.4,393871.078125,2722.8834617207503
49751,10024,10024,36061019900,226590,192056,Census Tract 199,New York,New York County,3487,5788,3641,3504,0,3238,249,17,137,137,0,122,15,0,2147,1835,0,1473,362,312,329,5.7,0.5,0.0,14.5,395872.2109375,2704.21498565226
49751,10025,10025,36061019900,226590,192056,Census Tract 199,New York,New York County,3487,5788,3641,3504,0,3238,249,17,137,137,0,122,15,0,2147,1835,0,1473,362,312,329,5.7,0.5,0.0,14.5,395872.2109375,2704.21498565226
49752,10026,10026,36061020000,129287,0,Census Tract 200,New York,New York County,1954,3034,2037,1996,42,1869,43,42,41,41,0,41,0,0,997,821,0,813,8,176,218,7.2,2.1,0.0,17.7,225876.55859375,2721.4888865133803
49752,10027,10027,36061020000,129287,0,Census Tract 200,New York,New York County,1954,3034,2037,1996,42,1869,43,42,41,41,0,41,0,0,997,821,0,813,8,176,218,7.2,2.1,0.0,17.7,225876.55859375,2721.4888865133803
49753,10025,10025,36061020101,55127,0,Census Tract 201.01,New York,New York County,298,539,300,298,0,254,44,0,2,2,0,0,2,0,239,239,0,201,38,0,0,0.0,0.0,0.0,0.0,96315.6015625,1342.0010677914302
49753,10027,10027,36061020101,55127,0,Census Tract 201.01,New York,New York County,298,539,300,298,0,254,44,0,2,2,0,0,2,0,239,239,0,201,38,0,0,0.0,0.0,0.0,0.0,96315.6015625,1342.0010677914302
49754,10026,10026,36061020102,83350,0,Census Tract 201.02,New York,New York County,2438,3578,2655,2477,0,2384,54,39,178,178,0,154,24,0,923,701,11,656,34,222,261,7.3,1.6,0.0,24.1,145618.61328125,1509.83953831181
49755,10027,10027,36061020300,178223,0,Census Tract 203,New York,New York County,356,713,364,360,0,268,88,4,4,4,0,4,0,0,349,302,0,261,41,47,51,7.2,1.1,0.0,13.5,311401.1484375,2444.8881509766297
49756,10024,10024,36061020500,281121,374540,Census Tract 205,New York,New York County,1255,1990,1307,1265,9,1074,172,10,42,42,0,42,0,0,683,634,9,546,79,49,59,3.0,0.8,0.0,7.2,491208.81640625,2894.62720479859
49756,10025,10025,36061020500,281121,374540,Census Tract 205,New York,New York County,1255,1990,1307,1265,9,1074,172,10,42,42,0,42,0,0,683,634,9,546,79,49,59,3.0,0.8,0.0,7.2,491208.81640625,2894.62720479859
49756,10027,10027,36061020500,281121,374540,Census Tract 205,New York,New York County,1255,1990,1307,1265,9,1074,172,10,42,42,0,42,0,0,683,634,9,546,79,49,59,3.0,0.8,0.0,7.2,491208.81640625,2894.62720479859
49756,10115,10027,36061020500,281121,374540,Census Tract 205,New York,New York County,1255,1990,1307,1265,9,1074,172,10,42,42,0,42,0,0,683,634,9,546,79,49,59,3.0,0.8,0.0,7.2,491208.81640625,2894.62720479859
49757,10035,10035,36061020600,148748,0,Census Tract 206,New York,New York County,1502,2763,1624,1545,0,1346,156,43,79,68,0,68,0,11,1139,785,0,663,122,354,408,14.8,2.8,13.9,31.1,259897.82421875,2084.5939591229503
49757,10037,10037,36061020600,148748,0,Census Tract 206,New York,New York County,1502,2763,1624,1545,0,1346,156,43,79,68,0,68,0,11,1139,785,0,663,122,354,408,14.8,2.8,13.9,31.1,259897.82421875,2084.5939591229503
49758,10027,10027,36061020701,47273,0,Census Tract 207.01,New York,New York County,1234,2218,1278,1268,0,1103,131,34,10,10,0,10,0,0,940,913,10,824,79,27,61,2.8,2.7,0.0,2.9,82600.55859375,1212.18312002953
49759,10027,10027,36061020800,148566,0,Census Tract 208,New York,New York County,2761,4308,3204,3011,0,2633,128,250,193,193,0,178,15,0,1104,931,0,855,76,173,423,9.8,8.3,0.0,15.7,259592.40234375,2085.36651290853
49759,10037,10037,36061020800,148566,0,Census Tract 208,New York,New York County,2761,4308,3204,3011,0,2633,128,250,193,193,0,178,15,0,1104,931,0,855,76,173,423,9.8,8.3,0.0,15.7,259592.40234375,2085.36651290853
49760,10027,10027,36061020901,115806,0,Census Tract 209.01,New York,New York County,1071,2884,1360,1273,0,897,174,202,87,79,0,79,0,8,1524,827,0,661,166,697,907,31.4,15.9,9.2,45.7,202361.84375,1936.9928723081698
49761,10037,10037,36061021000,203715,116287,Census Tract 210,New York,New York County,2301,5808,2777,2446,0,1896,405,145,331,313,0,252,61,18,3031,2394,27,2036,331,637,800,13.8,5.9,5.4,21.0,379805.9296875,3572.3403865626
49762,10024,10024,36061021100,347998,307945,Census Tract 211,New York,New York County,3906,8269,4221,3966,0,3653,253,60,255,255,0,255,0,0,4048,3182,0,2742,440,866,926,11.2,1.5,0.0,21.4,608143.3515625,3080.06421210157
49762,10027,10027,36061021100,347998,307945,Census Tract 211,New York,New York County,3906,8269,4221,3966,0,3653,253,60,255,255,0,255,0,0,4048,3182,0,2742,440,866,926,11.2,1.5,0.0,21.4,608143.3515625,3080.06421210157
49763,10037,10037,36061021200,176416,0,Census Tract 212,New York,New York County,1845,3438,2217,1862,0,1577,268,17,355,355,0,355,0,0,1221,938,0,813,125,283,300,8.7,0.9,0.0,23.2,308292.05078125,2321.77494912863
49764,10027,10027,36061021303,153292,0,Census Tract 213.03,New York,New York County,2856,4967,3375,3278,0,2635,221,422,97,93,0,93,0,4,1592,1137,0,1101,36,455,881,17.7,12.9,4.1,28.6,267887.70703125,2924.35159267329
49764,10031,10031,36061021303,153292,0,Census Tract 213.03,New York,New York County,2856,4967,3375,3278,0,2635,221,422,97,93,0,93,0,4,1592,1137,0,1101,36,455,881,17.7,12.9,4.1,28.6,267887.70703125,2924.35159267329
49765,10037,10037,36061021400,135562,0,Census Tract 214,New York,New York County,1929,3165,2275,2027,0,1780,149,98,248,227,0,194,33,21,890,671,0,559,112,219,338,10.7,4.8,8.5,24.6,236927.6875,1993.85211281513
49765,10039,10039,36061021400,135562,0,Census Tract 214,New York,New York County,1929,3165,2275,2027,0,1780,149,98,248,227,0,194,33,21,890,671,0,559,112,219,338,10.7,4.8,8.5,24.6,236927.6875,1993.85211281513
49766,10027,10027,36061021500,69708,0,Census Tract 215,New York,New York County,1867,3465,2116,2006,2,1693,172,139,110,110,1,109,0,0,1349,1119,2,956,161,230,369,10.6,6.9,0.0,17.0,121815.953125,2029.8316750859601
49766,10030,10030,36061021500,69708,0,Census Tract 215,New York,New York County,1867,3465,2116,2006,2,1693,172,139,110,110,1,109,0,0,1349,1119,2,956,161,230,369,10.6,6.9,0.0,17.0,121815.953125,2029.8316750859601
49767,10026,10026,36061021600,173198,0,Census Tract 216,New York,New York County,4527,6752,4761,4560,183,3980,364,33,201,201,0,201,0,0,1991,1720,0,1286,434,271,304,4.5,0.7,0.0,13.6,302548.05078125,2293.88161775941
49768,10027,10027,36061021703,313863,0,Census Tract 217.03,New York,New York County,4,8,4,4,0,4,0,0,0,0,0,0,0,0,4,4,0,4,0,0,0,0.0,0.0,,0.0,548549.7421875,3778.76379215716
49768,10031,10031,36061021703,313863,0,Census Tract 217.03,New York,New York County,4,8,4,4,0,4,0,0,0,0,0,0,0,0,4,4,0,4,0,0,0,0.0,0.0,,0.0,548549.7421875,3778.76379215716
49769,10026,10026,36061021800,181869,0,Census Tract 218,New York,New York County,3213,5655,3752,3355,0,2827,386,142,397,251,0,192,59,146,1903,1432,0,1219,213,471,759,13.4,4.2,36.8,24.8,317723.2734375,2326.06909785786
49770,10027,10027,36061021900,279408,191783,Census Tract 219,New York,New York County,1635,4596,2076,1808,0,1589,46,173,268,246,0,246,0,22,2520,1659,0,1256,403,861,1056,23.0,9.6,8.2,34.2,499656.890625,3947.6862158464796
49770,10031,10031,36061021900,279408,191783,Census Tract 219,New York,New York County,1635,4596,2076,1808,0,1589,46,173,268,246,0,246,0,22,2520,1659,0,1256,403,861,1056,23.0,9.6,8.2,34.2,499656.890625,3947.6862158464796
49771,10026,10026,36061022000,174955,0,Census Tract 220,New York,New York County,3206,5112,3741,3477,0,3049,157,271,264,212,0,190,22,52,1371,1013,0,1013,0,358,681,13.3,7.8,19.7,26.1,305663.85546875,2292.36087196594
49771,10027,10027,36061022000,174955,0,Census Tract 220,New York,New York County,3206,5112,3741,3477,0,3049,157,271,264,212,0,190,22,52,1371,1013,0,1013,0,358,681,13.3,7.8,19.7,26.1,305663.85546875,2292.36087196594
49772,10030,10030,36061022102,99000,0,Census Tract 221.02,New York,New York County,1558,2218,1726,1578,0,1437,121,20,148,117,0,87,30,31,492,372,0,315,57,120,171,7.7,1.3,20.9,24.4,173029.72265625,1973.33997588948
49773,10027,10027,36061022200,181422,0,Census Tract 222,New York,New York County,1439,2605,1522,1462,0,1344,95,23,60,52,0,42,10,8,1083,769,0,671,98,314,345,13.2,1.6,13.3,29.0,316989.55078125,2325.1901510916
49774,10031,10031,36061022301,186804,131253,Census Tract 223.01,New York,New York County,4598,7122,4961,4738,0,4058,540,140,223,223,0,223,0,0,2161,1872,0,1661,211,289,429,6.0,3.0,0.0,13.4,327100.046875,3002.52436900706
49775,10031,10031,36061022302,60095,96898,Census Tract 223.02,New York,New York County,1257,2895,1528,1398,0,1185,72,141,130,130,0,114,16,0,1367,866,0,814,52,501,642,22.2,10.1,0.0,36.6,107578.953125,1428.5746776796
49776,10027,10027,36061022400,194691,0,Census Tract 224,New York,New York County,2377,5825,3152,2935,13,2216,148,558,217,202,0,153,49,15,2673,1633,0,1264,369,1040,1613,27.7,19.0,6.9,38.9,340199.87890625,2494.9610083303196
49777,10031,10031,36061022500,262466,136149,Census Tract 225,New York,New York County,5474,8784,6093,5593,0,5173,301,119,500,500,0,455,45,0,2691,2223,0,2041,182,468,587,6.7,2.1,0.0,17.4,458809.74609375,2987.69846662065
49778,10027,10027,36061022600,152979,0,Census Tract 226,New York,New York County,2154,3868,2309,2225,0,1968,186,71,84,84,0,69,15,0,1559,1354,0,982,372,205,276,7.1,3.2,0.0,13.1,267332.9921875,2292.86913502908
49778,10030,10030,36061022600,152979,0,Census Tract 226,New York,New York County,2154,3868,2309,2225,0,1968,186,71,84,84,0,69,15,0,1559,1354,0,982,372,205,276,7.1,3.2,0.0,13.1,267332.9921875,2292.86913502908
49779,10030,10030,36061022700,150706,0,Census Tract 227,New York,New York County,2794,4260,3113,2955,0,2554,240,161,158,158,0,132,26,0,1147,763,0,649,114,384,545,12.8,5.4,0.0,33.5,263432.45703125,2211.4344813963603
49779,10031,10031,36061022700,150706,0,Census Tract 227,New York,New York County,2794,4260,3113,2955,0,2554,240,161,158,158,0,132,26,0,1147,763,0,649,114,384,545,12.8,5.4,0.0,33.5,263432.45703125,2211.4344813963603
49780,10030,10030,36061022800,180634,0,Census Tract 228,New York,New York County,2706,4910,3435,2886,0,2377,329,180,549,549,0,470,79,0,1475,1068,0,1010,58,407,587,12.0,6.2,0.0,27.6,315684.4609375,2319.56216471133
49780,10037,10037,36061022800,180634,0,Census Tract 228,New York,New York County,2706,4910,3435,2886,0,2377,329,180,549,549,0,470,79,0,1475,1068,0,1010,58,407,587,12.0,6.2,0.0,27.6,315684.4609375,2319.56216471133
49781,10031,10031,36061022900,211053,131446,Census Tract 229,New York,New York County,4515,7508,5121,4745,29,4127,359,230,376,267,0,255,12,109,2387,1956,0,1662,294,431,770,10.3,4.8,29.0,18.1,368956.18359375,3031.89624296281
49782,10030,10030,36061023000,173684,0,Census Tract 230,New York,New York County,3292,7014,4171,3470,0,3129,163,178,701,680,0,630,50,21,2843,2068,0,1717,351,775,974,13.9,5.1,3.0,27.3,303558.91015625,2285.8733007490196
49783,10031,10031,36061023100,182674,0,Census Tract 231,New York,New York County,4044,5796,4416,4137,0,3821,223,93,279,279,0,222,57,0,1380,1030,0,933,97,350,443,7.6,2.2,0.0,25.4,319344.2109375,2260.9973822028196
49784,10030,10030,36061023200,180486,0,Census Tract 232,New York,New York County,3653,6798,4509,3963,0,3432,221,310,546,546,0,471,75,0,2289,1943,0,1775,168,346,656,9.6,7.8,0.0,15.1,315470.84765625,2319.59757042012
49784,10039,10039,36061023200,180486,0,Census Tract 232,New York,New York County,3653,6798,4509,3963,0,3432,221,310,546,546,0,471,75,0,2289,1943,0,1775,168,346,656,9.6,7.8,0.0,15.1,315470.84765625,2319.59757042012
49785,10031,10031,36061023300,232212,285722,Census Tract 233,New York,New York County,4090,5827,4323,4235,0,3915,175,145,88,88,0,88,0,0,1504,1279,0,1202,77,225,370,6.3,3.4,0.0,15.0,405976.2734375,2831.07125222975
49786,10039,10039,36061023400,108235,0,Census Tract 234,New York,New York County,2385,4361,3047,2612,0,1961,424,227,435,358,0,301,57,77,1314,909,0,744,165,405,709,16.3,8.7,17.7,30.8,189199.078125,2278.35605111439
49787,10031,10031,36061023501,179045,0,Census Tract 235.01,New York,New York County,3751,5459,4311,3950,0,3633,118,199,361,361,0,330,31,0,1148,856,0,768,88,292,491,9.0,5.0,0.0,25.4,313028.87109375,2229.22306751327
49787,10032,10032,36061023501,179045,0,Census Tract 235.01,New York,New York County,3751,5459,4311,3950,0,3633,118,199,361,361,0,330,31,0,1148,856,0,768,88,292,491,9.0,5.0,0.0,25.4,313028.87109375,2229.22306751327
49788,10039,10039,36061023502,41338,0,Census Tract 235.02,New York,New York County,1008,1528,1092,1056,0,865,143,48,36,36,0,18,18,0,436,323,0,258,65,113,161,10.5,4.5,0.0,25.9,72266.95703125,1362.44795001244
49789,10039,10039,36061023600,263159,127979,Census Tract 236,New York,New York County,2810,5516,3432,3026,0,2689,121,216,406,388,0,373,15,18,2084,1606,0,1570,36,478,712,12.9,7.1,4.4,22.9,509760.203125,3764.3353133266705
49790,10031,10031,36061023700,271911,273621,Census Tract 237,New York,New York County,3724,6077,4212,3918,0,3506,218,194,294,279,0,268,11,15,1865,1600,0,1504,96,265,474,7.8,5.0,5.1,14.2,479257.16015625,2851.35249147768
49790,10032,10032,36061023700,271911,273621,Census Tract 237,New York,New York County,3724,6077,4212,3918,0,3506,218,194,294,279,0,268,11,15,1865,1600,0,1504,96,265,474,7.8,5.0,5.1,14.2,479257.16015625,2851.35249147768
49791,10044,10044,36061023801,352466,518659,Census Tract 238.01,New York,New York County,4322,7424,4722,4418,0,4256,66,96,304,304,0,304,0,0,2702,2369,0,2147,222,333,429,5.8,2.2,0.0,12.3,735342.9921875,9940.8246720644
49792,10044,10044,36061023802,243418,313651,Census Tract 238.02,New York,New York County,919,1398,969,919,0,877,42,0,50,50,0,50,0,0,429,375,0,356,19,54,54,3.9,0.0,0.0,12.6,448402.109375,6692.618867650861
49793,10032,10032,36061023900,63850,0,Census Tract 239,New York,New York County,1487,2762,1839,1525,26,1403,58,38,314,264,20,207,37,50,923,575,11,460,104,348,436,15.8,2.5,15.9,37.7,111640.47265625,1466.00795786057
49794,10035,10035,36061024000,2183933,793007,Census Tract 240,New York,New York County,0,0,0,0,0,0,0,0,0,0,0,0,0,0,0,0,0,0,0,0,0,,,,,3812226.9609375,15543.9709153786
49795,10032,10032,36061024100,178781,207330,Census Tract 241,New York,New York County,4399,7618,4942,4661,0,4102,297,262,281,281,0,281,0,0,2676,2115,0,1591,524,561,823,10.8,5.6,0.0,21.0,314222.5390625,2654.17227402865
49796,10035,10035,36061024200,347358,135919,Census Tract 242,New York,New York County,1460,3179,1805,1671,0,1363,97,211,134,89,0,89,0,45,1374,805,0,711,94,569,825,26.0,12.6,33.6,41.4,627594.22265625,3813.10723643029
49796,10037,10037,36061024200,347358,135919,Census Tract 242,New York,New York County,1460,3179,1805,1671,0,1363,97,211,134,89,0,89,0,45,1374,805,0,711,94,569,825,26.0,12.6,33.6,41.4,627594.22265625,3813.10723643029
49797,10032,10032,36061024301,105194,0,Census Tract 243.01,New York,New York County,2402,3982,2693,2477,0,2137,265,75,216,207,0,174,33,9,1289,1087,0,973,114,202,286,7.2,3.0,4.2,15.7,183949.7890625,1908.25505851909
49798,10039,10039,36061024302,213259,113258,Census Tract 243.02,New York,New York County,1958,5737,2970,2109,0,1614,344,151,861,812,0,562,250,49,2767,2131,0,1743,388,636,836,14.6,7.2,5.7,23.0,401064.88671875,3050.0756916074397
49799,10032,10032,36061024500,212070,0,Census Tract 245,New York,New York County,7723,13216,9274,8221,0,7147,576,498,1053,978,0,845,133,75,3942,3111,0,2587,524,831,1404,10.6,6.1,7.1,21.1,370848.5234375,2598.47777924041
49800,10032,10032,36061024700,256348,400307,Census Tract 247,New York,New York County,4446,6935,4691,4446,0,3901,545,0,245,245,0,218,27,0,2244,1903,0,1565,338,341,341,4.9,0.0,0.0,15.2,448310.20703125,2818.20676226768
49801,10032,10032,36061024900,60659,0,Census Tract 249,New York,New York County,560,950,628,583,0,543,17,23,45,35,0,26,9,10,322,204,0,142,62,118,151,15.9,3.9,22.2,36.6,106085.20703125,1584.86598489115
49802,10032,10032,36061025100,159422,0,Census Tract 251,New York,New York County,1024,1971,1218,1065,0,812,212,41,153,153,0,94,59,0,753,587,0,380,207,166,207,10.5,3.8,0.0,22.0,278816.23828125,2166.92765482911
49803,10032,10032,36061025300,169349,0,Census Tract 253,New York,New York County,6759,11342,7874,7160,0,6303,456,401,714,700,0,521,179,14,3468,2871,62,2600,209,597,1012,8.9,5.6,2.0,17.2,296202.84375,2277.51036001247
49804,10032,10032,36061025500,441356,586786,Census Tract 255,New York,New York County,2778,4991,2965,2899,0,2505,273,121,66,66,0,66,0,0,2026,1649,0,1208,441,377,498,10.0,4.2,0.0,18.6,775314.8125,4430.75712467267
49804,10033,10033,36061025500,441356,586786,Census Tract 255,New York,New York County,2778,4991,2965,2899,0,2505,273,121,66,66,0,66,0,0,2026,1649,0,1208,441,377,498,10.0,4.2,0.0,18.6,775314.8125,4430.75712467267
49805,10026,10026,36061025700,144063,0,Census Tract 257,New York,New York County,2364,3730,2639,2494,0,2338,26,130,145,145,0,135,10,0,1091,1003,0,982,21,88,218,5.8,5.2,0.0,8.1,251714.3203125,2442.2862196608603
49805,10027,10027,36061025700,144063,0,Census Tract 257,New York,New York County,2364,3730,2639,2494,0,2338,26,130,145,145,0,135,10,0,1091,1003,0,982,21,88,218,5.8,5.2,0.0,8.1,251714.3203125,2442.2862196608603
49806,10030,10030,36061025900,75469,0,Census Tract 259,New York,New York County,2278,2959,2450,2328,0,2184,94,50,122,113,0,113,0,9,509,426,0,281,145,83,142,4.8,2.1,7.4,16.3,131920.3515625,2222.66868348632
49806,10039,10039,36061025900,75469,0,Census Tract 259,New York,New York County,2278,2959,2450,2328,0,2184,94,50,122,113,0,113,0,9,509,426,0,281,145,83,142,4.8,2.1,7.4,16.3,131920.3515625,2222.66868348632
49807,10033,10033,36061026100,156222,0,Census Tract 261,New York,New York County,5829,10714,7016,6123,16,5036,777,294,893,846,0,637,209,47,3698,2506,22,2078,406,1192,1533,14.3,4.8,5.3,32.2,273265.40234375,2230.86233014682
49808,10032,10032,36061026300,157201,0,Census Tract 263,New York,New York County,4834,7850,5362,4934,0,4438,396,100,428,428,0,357,71,0,2488,2062,0,1908,154,426,526,6.7,2.0,0.0,17.1,274979.87890625,2310.75429624559
49808,10033,10033,36061026300,157201,0,Census Tract 263,New York,New York County,4834,7850,5362,4934,0,4438,396,100,428,428,0,357,71,0,2488,2062,0,1908,154,426,526,6.7,2.0,0.0,17.1,274979.87890625,2310.75429624559
49809,10033,10033,36061026500,195037,0,Census Tract 265,New York,New York County,4375,7059,4982,4569,0,4089,286,194,413,361,0,356,5,52,2077,1561,0,1476,85,516,762,10.8,4.2,12.6,24.8,341195.3984375,2605.16900355719
49810,10033,10033,36061026700,47338,0,Census Tract 267,New York,New York County,675,1232,778,718,0,643,32,43,60,60,0,60,0,0,454,376,0,330,46,78,121,9.8,6.0,0.0,17.2,82815.5078125,1538.17328823125
49811,10033,10033,36061026900,175570,0,Census Tract 269,New York,New York County,3900,7518,4759,4293,12,3653,235,393,466,466,0,466,0,0,2759,2086,0,1965,121,673,1066,14.2,9.2,0.0,24.4,307151.6875,2426.92323697676
49811,10040,10040,36061026900,175570,0,Census Tract 269,New York,New York County,3900,7518,4759,4293,12,3653,235,393,466,466,0,466,0,0,2759,2086,0,1965,121,673,1066,14.2,9.2,0.0,24.4,307151.6875,2426.92323697676
49812,10033,10033,36061027100,192909,0,Census Tract 271,New York,New York County,4662,8262,5629,4887,50,4378,234,225,742,742,0,668,74,0,2633,2269,34,2094,141,364,589,7.1,4.6,0.0,13.8,337497.9296875,2615.51943002103
49813,10033,10033,36061027300,176946,0,Census Tract 273,New York,New York County,4270,5768,4419,4270,0,4126,144,0,149,149,0,149,0,0,1349,1020,0,1020,0,329,329,5.7,0.0,0.0,24.4,309588.58203125,3412.82374262511
49813,10040,10040,36061027300,176946,0,Census Tract 273,New York,New York County,4270,5768,4419,4270,0,4126,144,0,149,149,0,149,0,0,1349,1020,0,1020,0,329,329,5.7,0.0,0.0,24.4,309588.58203125,3412.82374262511
49814,10033,10033,36061027500,279689,852909,Census Tract 275,New York,New York County,1873,2910,2073,1892,0,1786,87,19,181,181,0,181,0,0,837,753,0,716,37,84,103,3.5,1.0,0.0,10.0,512816.7890625,4303.99256761817
49814,10034,10034,36061027500,279689,852909,Census Tract 275,New York,New York County,1873,2910,2073,1892,0,1786,87,19,181,181,0,181,0,0,837,753,0,716,37,84,103,3.5,1.0,0.0,10.0,512816.7890625,4303.99256761817
49814,10040,10040,36061027500,279689,852909,Census Tract 275,New York,New York County,1873,2910,2073,1892,0,1786,87,19,181,181,0,181,0,0,837,753,0,716,37,84,103,3.5,1.0,0.0,10.0,512816.7890625,4303.99256761817
49815,10040,10040,36061027700,163262,0,Census Tract 277,New York,New York County,2165,4465,2847,2394,23,1848,294,229,453,414,0,388,26,39,1618,1059,12,900,147,559,827,18.5,9.6,8.6,34.5,285662.83984375,2289.29719170398
49816,10040,10040,36061027900,180014,0,Census Tract 279,New York,New York County,5012,9726,6105,5415,0,4756,256,403,690,672,0,598,74,18,3621,2860,0,2680,180,761,1182,12.2,7.4,2.6,21.0,314971.91015625,2977.18008042601
49817,10040,10040,36061028100,94227,0,Census Tract 281,New York,New York County,1812,2537,1855,1846,0,1768,44,34,9,9,0,9,0,0,682,513,0,499,14,169,203,8.0,1.8,0.0,24.8,164876.16796875,2003.12454519225
49818,10040,10040,36061028300,151093,0,Census Tract 283,New York,New York County,3748,6714,4199,3797,0,3652,96,49,402,402,0,402,0,0,2515,1872,0,1637,235,643,692,10.3,1.3,0.0,25.6,264397.640625,2509.01114635693
49819,10040,10040,36061028500,121942,0,Census Tract 285,New York,New York County,3960,6721,4640,4010,0,3867,93,50,630,630,0,618,12,0,2081,1723,0,1658,65,358,408,6.1,1.2,0.0,17.2,213401.57421875,2060.3519696176104
49820,10034,10034,36061028700,532366,1018817,Census Tract 287,New York,New York County,2180,3504,2468,2270,0,2136,44,90,198,170,0,170,0,28,1036,835,0,753,82,201,319,9.1,4.0,14.1,19.4,943829.98828125,4641.78611376574
49820,10040,10040,36061028700,532366,1018817,Census Tract 287,New York,New York County,2180,3504,2468,2270,0,2136,44,90,198,170,0,170,0,28,1036,835,0,753,82,201,319,9.1,4.0,14.1,19.4,943829.98828125,4641.78611376574
49821,10034,10034,36061029100,187479,0,Census Tract 291,New York,New York County,5952,10061,6557,6095,0,5543,409,143,462,414,0,359,55,48,3504,3103,0,2884,219,401,592,5.9,2.3,10.4,11.4,328119.20703125,2306.11184907513
49821,10040,10040,36061029100,187479,0,Census Tract 291,New York,New York County,5952,10061,6557,6095,0,5543,409,143,462,414,0,359,55,48,3504,3103,0,2884,219,401,592,5.9,2.3,10.4,11.4,328119.20703125,2306.11184907513
49822,10034,10034,36061029300,157076,0,Census Tract 293,New York,New York County,4034,7347,4588,4239,0,3541,493,205,349,311,0,311,0,38,2759,2296,0,1917,379,463,706,9.6,4.8,10.9,16.8,274925.70703125,2214.2269059686605
49823,10034,10034,36061029500,135565,0,Census Tract 295,New York,New York County,4743,7136,5437,4850,0,4451,292,107,587,569,0,569,0,18,1699,1390,0,1359,31,309,434,6.1,2.2,3.1,18.2,237285.14453125,2109.68525024086
49824,10034,10034,36061029700,948118,1006331,Census Tract 297,New York,New York County,0,0,0,0,0,0,0,0,0,0,0,0,0,0,0,0,0,0,0,0,0,,,,,1790858.97265625,8860.020870971679
49825,10034,10034,36061029900,616053,322917,Census Tract 299,New York,New York County,1145,3192,1549,1328,8,1121,16,183,221,221,0,221,0,0,1643,1280,0,1261,19,363,546,17.1,13.8,0.0,22.1,1069691.58984375,7562.704875249441
49826,10034,10034,36061030300,156650,0,Census Tract 303,New York,New York County,2413,3815,2629,2527,0,2378,35,114,102,102,0,102,0,0,1186,960,0,949,11,226,340,8.9,4.5,0.0,19.1,274206.75,2480.37432082644
49827,10034,10034,36061030700,84374,0,Census Tract 307,New York,New York County,2242,3326,2457,2366,9,1914,319,124,91,82,0,74,8,9,869,624,0,523,101,245,378,11.4,5.2,9.9,28.2,147699.515625,1672.27992139665
49828,10463,10463,36061030900,302751,0,Census Tract 309,New York,New York County,4225,8301,5094,4532,0,3662,563,307,562,512,0,491,21,50,3207,2606,0,2351,255,601,958,11.5,6.8,8.9,18.7,530051.93359375,3149.31689455002
49829,10033,10033,36061031100,730774,312736,Census Tract 311,New York,New York County,0,0,0,0,0,0,0,0,0,0,0,0,0,0,0,0,0,0,0,0,0,,,,,1353291.51953125,12627.9890930504
49829,10039,10039,36061031100,730774,312736,Census Tract 311,New York,New York County,0,0,0,0,0,0,0,0,0,0,0,0,0,0,0,0,0,0,0,0,0,,,,,1353291.51953125,12627.9890930504
49830,10280,10280,36061031703,248049,467877,Census Tract 317.03,New York,New York County,2895,3898,2989,2895,0,2895,0,0,94,94,0,94,0,0,909,881,0,866,15,28,28,0.7,0.0,0.0,3.1,535709.8828125,3313.63660535906
49830,10282,10282,36061031703,248049,467877,Census Tract 317.03,New York,New York County,2895,3898,2989,2895,0,2895,0,0,94,94,0,94,0,0,909,881,0,866,15,28,28,0.7,0.0,0.0,3.1,535709.8828125,3313.63660535906
49831,10004,10004,36061031704,225055,472761,Census Tract 317.04,New York,New York County,6381,8037,6619,6403,0,6251,130,22,216,216,0,216,0,0,1418,1371,0,1348,23,47,69,0.9,0.3,0.0,3.3,445650.640625,3249.88841360129
49831,10280,10280,36061031704,225055,472761,Census Tract 317.04,New York,New York County,6381,8037,6619,6403,0,6251,130,22,216,216,0,216,0,0,1418,1371,0,1348,23,47,69,0.9,0.3,0.0,3.3,445650.640625,3249.88841360129
49832,10004,10004,36061031900,99774,317234,Census Tract 319,New York,New York County,0,0,0,0,0,0,0,0,0,0,0,0,0,0,0,0,0,0,0,0,0,,,,,223656.35546875,2549.87531442406
49832,10280,10280,36061031900,99774,317234,Census Tract 319,New York,New York County,0,0,0,0,0,0,0,0,0,0,0,0,0,0,0,0,0,0,0,0,0,,,,,223656.35546875,2549.87531442406
49833,11101,11101,36081000100,1139955,172724,Census Tract 1,New York,Queens County,5898,7187,6145,5931,0,5881,17,33,214,214,0,214,0,0,1042,1042,0,954,88,0,33,0.5,0.6,0.0,0.0,1978662.62109375,13224.989457053201
49833,11109,11109,36081000100,1139955,172724,Census Tract 1,New York,Queens County,5898,7187,6145,5931,0,5881,17,33,214,214,0,214,0,0,1042,1042,0,954,88,0,33,0.5,0.6,0.0,0.0,1978662.62109375,13224.989457053201
49834,11421,11421,36081000200,156595,0,Census Tract 2,New York,Queens County,1723,2653,1859,1765,0,1614,109,42,94,94,0,79,15,0,794,732,0,640,92,62,104,3.9,2.4,0.0,7.8,272671.984375,2074.62960721053
49835,11421,11421,36081000400,224878,0,Census Tract 4,New York,Queens County,2043,3624,2124,2043,0,2002,41,0,81,81,0,71,10,0,1500,1479,0,1374,105,21,21,0.6,0.0,0.0,1.4,391530.3203125,2617.4513355943104
49836,11421,11421,36081000600,214286,0,Census Tract 6,New York,Queens County,1728,2920,1927,1774,0,1576,152,46,153,153,0,153,0,0,993,919,0,815,104,74,120,4.1,2.6,0.0,7.5,373044.46875,2586.1180701283397
49837,11101,11101,36081000700,545045,0,Census Tract 7,New York,Queens County,3990,5100,4261,4025,0,3910,80,35,236,236,0,236,0,0,839,716,0,716,0,123,158,3.1,0.9,0.0,14.7,950516.5859375,4357.00813100303
49838,11421,11421,36081000800,189824,0,Census Tract 8,New York,Queens County,1379,2457,1529,1388,0,1361,18,9,141,141,0,141,0,0,928,842,0,777,65,86,95,3.9,0.6,0.0,9.3,330473.21875,2375.33742383424
49839,11421,11421,36081001000,161256,0,Census Tract 10,New York,Queens County,2181,3366,2282,2206,0,2038,143,25,76,76,0,70,6,0,1084,1020,0,909,111,64,89,2.6,1.1,0.0,5.9,280765.86328125,2118.11311038626
49840,11421,11421,36081001200,227157,0,Census Tract 12,New York,Queens County,1864,3188,2091,1989,0,1852,12,125,102,102,0,102,0,0,1097,1009,7,938,64,88,213,6.7,6.3,0.0,8.0,395550.91796875,2547.1884776181
49841,11421,11421,36081001400,213714,0,Census Tract 14,New York,Queens County,2032,3328,2241,2076,0,1913,119,44,165,131,0,131,0,34,1087,963,0,911,52,124,202,6.1,2.1,20.6,11.4,372152.55859375,2443.41223161632
49842,11421,11421,36081001600,151499,0,Census Tract 16,New York,Queens County,1333,2287,1573,1387,11,1252,70,54,186,186,5,181,0,0,714,630,12,579,39,84,138,6.0,3.9,0.0,11.8,263772.67578125,2418.38951616604
49843,11421,11421,36081001800,177489,0,Census Tract 18,New York,Queens County,1372,2303,1474,1398,0,1247,125,26,76,71,0,71,0,5,829,735,0,590,145,94,125,5.4,1.9,6.6,11.3,309024.01953125,2481.17231118403
49844,11101,11101,36081001900,867933,0,Census Tract 19,New York,Queens County,2472,3010,2550,2472,0,2466,6,0,78,78,0,78,0,0,460,450,0,450,0,10,10,0.3,0.0,0.0,2.2,1513782.8046875,6182.04315904415
49845,11421,11421,36081002000,146397,0,Census Tract 20,New York,Queens County,928,1589,1067,943,0,835,93,15,124,114,0,104,10,10,522,495,0,448,47,27,52,3.3,1.6,8.1,5.2,254898.7890625,2388.7152235129997
49846,11421,11421,36081002200,147490,0,Census Tract 22,New York,Queens County,1133,1819,1303,1171,0,1070,63,38,132,132,0,126,6,0,516,485,0,417,68,31,69,3.8,3.2,0.0,6.0,256836.78515625,2013.3186770537698
49847,11418,11418,36081002400,141901,0,Census Tract 24,New York,Queens County,1062,1921,1196,1072,0,991,71,10,124,124,0,114,10,0,725,712,0,665,47,13,23,1.2,0.9,0.0,1.8,247112.2890625,2155.4713579805803
49847,11421,11421,36081002400,141901,0,Census Tract 24,New York,Queens County,1062,1921,1196,1072,0,991,71,10,124,124,0,114,10,0,725,712,0,665,47,13,23,1.2,0.9,0.0,1.8,247112.2890625,2155.4713579805803
49848,11101,11101,36081002500,210427,0,Census Tract 25,New York,Queens County,2049,5588,2677,2168,0,1863,186,119,509,466,0,429,37,43,2911,1949,41,1518,390,962,1124,20.1,5.5,8.4,33.0,367083.11328125,2433.62542303784
49849,11418,11418,36081002600,148030,0,Census Tract 26,New York,Queens County,1122,1779,1158,1122,0,984,138,0,36,36,0,22,14,0,621,621,0,490,131,0,0,0.0,0.0,0.0,0.0,257791.47265625,2489.38021250468
49850,11418,11418,36081002800,225043,0,Census Tract 28,New York,Queens County,1615,2674,1785,1666,0,1500,115,51,119,119,0,113,6,0,889,793,0,738,55,96,147,5.5,3.1,0.0,10.8,391847.38671875,2599.7693978542998
49850,11421,11421,36081002800,225043,0,Census Tract 28,New York,Queens County,1615,2674,1785,1666,0,1500,115,51,119,119,0,113,6,0,889,793,0,738,55,96,147,5.5,3.1,0.0,10.8,391847.38671875,2599.7693978542998
49851,11421,11421,36081003000,112790,0,Census Tract 30,New York,Queens County,527,1157,600,535,0,491,36,8,65,65,0,59,6,0,557,522,0,474,48,35,43,3.7,1.5,0.0,6.3,196385.01953125,2269.6420041081196
49852,11101,11101,36081003100,164962,0,Census Tract 31,New York,Queens County,586,897,617,586,0,553,33,0,31,31,0,31,0,0,280,262,0,253,9,18,18,2.0,0.0,0.0,6.4,287752.3359375,2688.90172354077
49853,11416,11416,36081003200,161964,0,Census Tract 32,New York,Queens County,847,1437,951,893,0,803,44,46,58,39,0,39,0,19,486,458,0,439,19,28,93,6.5,5.2,32.8,5.8,281966.9453125,2268.57631192651
49854,11101,11101,36081003300,509003,0,Census Tract 33,New York,Queens County,1904,2791,2054,1911,0,1816,88,7,143,143,0,93,50,0,737,706,0,706,0,31,38,1.4,0.4,0.0,4.2,887915.90625,5005.39788524397
49854,11106,11106,36081003300,509003,0,Census Tract 33,New York,Queens County,1904,2791,2054,1911,0,1816,88,7,143,143,0,93,50,0,737,706,0,706,0,31,38,1.4,0.4,0.0,4.2,887915.90625,5005.39788524397
49855,11416,11416,36081003400,213987,0,Census Tract 34,New York,Queens County,1011,1949,1122,1022,0,980,31,11,100,100,0,100,0,0,827,794,0,786,8,33,44,2.3,1.1,0.0,4.0,372509.1953125,4163.81091450259
49856,11416,11416,36081003600,180006,0,Census Tract 36,New York,Queens County,1749,2837,1876,1764,0,1749,0,15,112,112,0,112,0,0,961,884,0,875,9,77,92,3.2,0.9,0.0,8.0,313348.10546875,3769.69859301285
49857,11101,11101,36081003700,386629,14591,Census Tract 37,New York,Queens County,0,0,0,0,0,0,0,0,0,0,0,0,0,0,0,0,0,0,0,0,0,,,,,658916.48046875,7047.027923539441
49857,11106,11106,36081003700,386629,14591,Census Tract 37,New York,Queens County,0,0,0,0,0,0,0,0,0,0,0,0,0,0,0,0,0,0,0,0,0,,,,,658916.48046875,7047.027923539441
49858,11416,11416,36081003800,176214,0,Census Tract 38,New York,Queens County,1209,2049,1363,1275,0,1139,70,66,88,65,0,65,0,23,686,552,0,496,56,134,223,10.9,5.2,26.1,19.5,306756.38671875,2858.6973414132203
49859,11101,11101,36081003900,146970,0,Census Tract 39,New York,Queens County,640,980,710,658,0,594,46,18,52,52,0,35,17,0,270,258,15,232,11,12,30,3.1,2.7,0.0,4.4,256444.21484375,2887.36119391451
49859,11106,11106,36081003900,146970,0,Census Tract 39,New York,Queens County,640,980,710,658,0,594,46,18,52,52,0,35,17,0,270,258,15,232,11,12,30,3.1,2.7,0.0,4.4,256444.21484375,2887.36119391451
49860,11416,11416,36081004001,174292,0,Census Tract 40.01,New York,Queens County,1023,1874,1156,1068,0,1017,6,45,88,77,0,77,0,11,718,637,0,624,13,81,137,7.3,4.2,12.5,11.3,303393.09765625,2755.43333076088
49861,11417,11417,36081004002,130914,0,Census Tract 40.02,New York,Queens County,788,1316,891,837,63,720,5,49,54,54,0,50,4,0,425,416,16,391,9,9,58,4.4,5.9,0.0,2.1,227876.61328125,2311.53428926688
49862,11416,11416,36081004200,200287,0,Census Tract 42,New York,Queens County,1944,3506,2164,2000,0,1904,40,56,164,156,0,156,0,8,1342,1232,0,1225,7,110,174,5.0,2.8,4.9,8.2,348628.31640625,3185.1482771271803
49863,11101,11101,36081004300,170813,0,Census Tract 43,New York,Queens County,909,1928,1199,1028,0,758,151,119,171,171,0,171,0,0,729,580,0,437,143,149,268,13.9,11.6,0.0,20.4,298028.68359375,2578.53556211071
49863,11106,11106,36081004300,170813,0,Census Tract 43,New York,Queens County,909,1928,1199,1028,0,758,151,119,171,171,0,171,0,0,729,580,0,437,143,149,268,13.9,11.6,0.0,20.4,298028.68359375,2578.53556211071
49864,11416,11416,36081004401,258228,0,Census Tract 44.01,New York,Queens County,1595,2864,1687,1630,0,1577,18,35,57,57,0,57,0,0,1177,1091,0,1081,10,86,121,4.2,2.1,0.0,7.3,449424.69140625,3041.18631400112
49864,11417,11417,36081004401,258228,0,Census Tract 44.01,New York,Queens County,1595,2864,1687,1630,0,1577,18,35,57,57,0,57,0,0,1177,1091,0,1081,10,86,121,4.2,2.1,0.0,7.3,449424.69140625,3041.18631400112
49865,11106,11106,36081004500,220374,0,Census Tract 45,New York,Queens County,1742,2913,1896,1767,16,1683,43,25,129,119,0,119,0,10,1017,707,0,691,16,310,345,11.8,1.4,7.8,30.5,384543.95703125,3194.20706326051
49866,11106,11106,36081004700,179250,0,Census Tract 47,New York,Queens County,1679,2927,1909,1797,0,1583,96,118,112,112,0,101,11,0,1018,749,0,660,89,269,387,13.2,6.6,0.0,26.4,312742.12890625,2240.11250678441
49867,11417,11417,36081005000,157058,0,Census Tract 50,New York,Queens County,53,72,53,53,0,53,0,0,0,0,0,0,0,0,19,19,0,19,0,0,0,0.0,0.0,,0.0,273351.47265625,2139.45330604224
49868,11101,11101,36081005100,137123,0,Census Tract 51,New York,Queens County,931,1602,1163,986,0,903,28,55,177,173,0,142,31,4,439,316,0,304,12,123,182,11.4,5.6,2.3,28.0,239210.40234375,2168.62318832445
49868,11106,11106,36081005100,137123,0,Census Tract 51,New York,Queens County,931,1602,1163,986,0,903,28,55,177,173,0,142,31,4,439,316,0,304,12,123,182,11.4,5.6,2.3,28.0,239210.40234375,2168.62318832445
49869,11416,11416,36081005200,130613,0,Census Tract 52,New York,Queens County,1241,2183,1419,1253,0,1179,62,12,166,155,0,129,26,11,764,729,0,676,53,35,58,2.7,1.0,6.6,4.6,227344.41796875,2138.45863028987
49869,11417,11417,36081005200,130613,0,Census Tract 52,New York,Queens County,1241,2183,1419,1253,0,1179,62,12,166,155,0,129,26,11,764,729,0,676,53,35,58,2.7,1.0,6.6,4.6,227344.41796875,2138.45863028987
49870,11106,11106,36081005300,196497,0,Census Tract 53,New York,Queens County,2982,4198,3267,3045,0,2851,131,63,222,222,0,222,0,0,931,723,0,696,27,208,271,6.5,2.1,0.0,22.3,342835.62109375,3435.5045065537797
49871,11416,11416,36081005400,416542,0,Census Tract 54,New York,Queens County,2916,4898,3237,2956,26,2737,153,40,281,281,0,281,0,0,1661,1493,0,1285,208,168,208,4.2,1.4,0.0,10.1,724994.35546875,3824.89008899193
49871,11417,11417,36081005400,416542,0,Census Tract 54,New York,Queens County,2916,4898,3237,2956,26,2737,153,40,281,281,0,281,0,0,1661,1493,0,1285,208,168,208,4.2,1.4,0.0,10.1,724994.35546875,3824.89008899193
49872,11101,11101,36081005500,165967,0,Census Tract 55,New York,Queens County,483,783,514,494,0,475,8,11,20,20,0,20,0,0,269,203,0,182,21,66,77,9.8,2.2,0.0,24.5,289511.16015625,2120.26926854645
49872,11106,11106,36081005500,165967,0,Census Tract 55,New York,Queens County,483,783,514,494,0,475,8,11,20,20,0,20,0,0,269,203,0,182,21,66,77,9.8,2.2,0.0,24.5,289511.16015625,2120.26926854645
49873,11101,11101,36081005700,223565,0,Census Tract 57,New York,Queens County,2584,3908,2948,2644,0,2437,147,60,304,304,0,189,115,0,960,767,0,752,15,193,253,6.5,2.3,0.0,20.1,390025.9375,2739.11579384768
49873,11106,11106,36081005700,223565,0,Census Tract 57,New York,Queens County,2584,3908,2948,2644,0,2437,147,60,304,304,0,189,115,0,960,767,0,752,15,193,253,6.5,2.3,0.0,20.1,390025.9375,2739.11579384768
49874,11417,11417,36081005800,590419,0,Census Tract 58,New York,Queens County,2769,5174,3071,2843,0,2735,34,74,228,228,0,228,0,0,2103,1908,0,1844,64,195,269,5.2,2.6,0.0,9.3,1027470.16015625,4772.615711997621
49875,11103,11103,36081005900,190210,0,Census Tract 59,New York,Queens County,2603,3780,2806,2663,0,2363,240,60,143,143,0,114,29,0,974,739,9,634,96,235,295,7.8,2.3,0.0,24.1,331860.1796875,2466.88956987151
49875,11106,11106,36081005900,190210,0,Census Tract 59,New York,Queens County,2603,3780,2806,2663,0,2363,240,60,143,143,0,114,29,0,974,739,9,634,96,235,295,7.8,2.3,0.0,24.1,331860.1796875,2466.88956987151
49876,11103,11103,36081006100,195052,0,Census Tract 61,New York,Queens County,3756,5087,4012,3843,27,3642,87,87,169,169,0,169,0,0,1075,731,0,731,0,344,431,8.5,2.3,0.0,32.0,340334.078125,2489.04779401614
49876,11106,11106,36081006100,195052,0,Census Tract 61,New York,Queens County,3756,5087,4012,3843,27,3642,87,87,169,169,0,169,0,0,1075,731,0,731,0,344,431,8.5,2.3,0.0,32.0,340334.078125,2489.04779401614
49877,11414,11414,36081006201,402908,0,Census Tract 62.01,New York,Queens County,2491,5221,2848,2570,0,2448,43,79,278,278,0,278,0,0,2373,1728,0,1632,96,645,724,13.9,3.1,0.0,27.2,701017.1953125,3339.60278529795
49878,11414,11414,36081006202,1152998,42795,Census Tract 62.02,New York,Queens County,3136,5389,3629,3377,96,3007,33,241,252,234,0,234,0,18,1760,1493,0,1459,34,267,526,9.8,7.1,7.1,15.2,2034074.00390625,10918.185736025
49879,11102,11102,36081006300,212503,0,Census Tract 63,New York,Queens County,3222,4717,3529,3330,0,3174,48,108,199,199,0,199,0,0,1188,870,0,870,0,318,426,9.0,3.2,0.0,26.8,370809.65625,2557.54157693432
49879,11103,11103,36081006300,212503,0,Census Tract 63,New York,Queens County,3222,4717,3529,3330,0,3174,48,108,199,199,0,199,0,0,1188,870,0,870,0,318,426,9.0,3.2,0.0,26.8,370809.65625,2557.54157693432
49880,11102,11102,36081006501,111103,0,Census Tract 65.01,New York,Queens County,2401,3155,2558,2439,0,2363,38,38,119,119,0,112,7,0,597,478,0,431,47,119,157,5.0,1.6,0.0,19.9,193890.60546875,2059.9161171978
49880,11103,11103,36081006501,111103,0,Census Tract 65.01,New York,Queens County,2401,3155,2558,2439,0,2363,38,38,119,119,0,112,7,0,597,478,0,431,47,119,157,5.0,1.6,0.0,19.9,193890.60546875,2059.9161171978
49881,11103,11103,36081006502,153366,0,Census Tract 65.02,New York,Queens County,2397,3274,2642,2460,0,2253,144,63,182,182,0,182,0,0,632,507,0,489,18,125,188,5.7,2.6,0.0,19.8,267634.4921875,2378.96643951941
49882,11102,11102,36081006900,210779,0,Census Tract 69,New York,Queens County,1899,2945,2147,1969,0,1762,137,70,178,178,0,178,0,0,798,640,0,596,44,158,228,7.7,3.6,0.0,19.8,367878.546875,2669.08738955902
49883,11102,11102,36081007100,195059,0,Census Tract 71,New York,Queens County,2269,3135,2373,2302,0,2148,121,33,71,71,0,71,0,0,762,666,0,594,72,96,129,4.1,1.4,0.0,12.6,340415.234375,3490.29227544977
49884,11102,11102,36081007300,141556,0,Census Tract 73,New York,Queens County,2550,3655,2753,2667,10,2515,25,117,86,86,0,86,0,0,902,788,0,739,49,114,231,6.3,4.4,0.0,12.6,247026.70703125,2001.92713306163
49884,11106,11106,36081007300,141556,0,Census Tract 73,New York,Queens County,2550,3655,2753,2667,10,2515,25,117,86,86,0,86,0,0,902,788,0,739,49,114,231,6.3,4.4,0.0,12.6,247026.70703125,2001.92713306163
49885,11106,11106,36081007500,129231,0,Census Tract 75,New York,Queens County,2400,3726,2680,2467,12,2388,0,67,213,213,0,213,0,0,1046,832,0,818,14,214,281,7.5,2.7,0.0,20.5,225502.203125,1916.7466653426002
49886,11106,11106,36081007700,126674,0,Census Tract 77,New York,Queens County,1110,1516,1216,1182,0,1083,27,72,34,34,0,34,0,0,300,288,0,274,14,12,84,5.5,6.1,0.0,4.0,221056.765625,1952.3750317805102
49887,11102,11102,36081007900,160511,0,Census Tract 79,New York,Queens County,1511,2426,1604,1511,0,1399,112,0,93,86,0,86,0,7,822,615,0,544,71,207,214,8.8,0.0,7.5,25.2,280122.78125,2160.52364179328
49888,11102,11102,36081008100,112317,0,Census Tract 81,New York,Queens County,875,1201,943,885,0,793,82,10,58,58,0,48,10,0,258,258,0,218,40,0,10,0.8,1.1,0.0,0.0,196021.65625,2308.34026517309
49888,11106,11106,36081008100,112317,0,Census Tract 81,New York,Queens County,875,1201,943,885,0,793,82,10,58,58,0,48,10,0,258,258,0,218,40,0,10,0.8,1.1,0.0,0.0,196021.65625,2308.34026517309
49889,11102,11102,36081008300,191339,0,Census Tract 83,New York,Queens County,1570,2175,1631,1570,0,1355,215,0,61,61,0,61,0,0,544,519,0,443,76,25,25,1.1,0.0,0.0,4.6,333956.0703125,2837.6644109970503
49890,11101,11101,36081008500,273044,0,Census Tract 85,New York,Queens County,401,704,464,431,0,343,58,30,33,33,0,33,0,0,240,240,0,240,0,0,30,4.3,7.0,0.0,0.0,476382.515625,4488.043316963211
49890,11106,11106,36081008500,273044,0,Census Tract 85,New York,Queens County,401,704,464,431,0,343,58,30,33,33,0,33,0,0,240,240,0,240,0,0,30,4.3,7.0,0.0,0.0,476382.515625,4488.043316963211
49891,11417,11417,36081008600,332283,0,Census Tract 86,New York,Queens County,1415,2311,1557,1421,0,1386,29,6,136,136,0,130,6,0,754,673,0,673,0,81,87,3.8,0.4,0.0,10.7,578311.80078125,3240.1227372121
49892,11102,11102,36081008700,253377,2387,Census Tract 87,New York,Queens County,1379,3272,1733,1470,10,1092,277,91,263,224,0,184,40,39,1539,1127,30,937,160,412,542,16.6,6.2,14.8,26.8,433937.71484375,2869.78998507289
49893,11417,11417,36081008800,448520,0,Census Tract 88,New York,Queens County,1615,2964,1831,1702,0,1596,19,87,129,129,0,129,0,0,1133,1022,0,984,38,111,198,6.7,5.1,0.0,9.8,780469.7734375,3843.39976340299
49894,11102,11102,36081009100,186329,0,Census Tract 91,New York,Queens County,1211,2287,1345,1244,0,1050,161,33,101,87,0,87,0,14,942,832,0,705,127,110,157,6.9,2.7,13.9,11.7,308774.2421875,3798.31996555035
49895,11417,11417,36081009400,172430,0,Census Tract 94,New York,Queens County,1199,2216,1376,1270,0,1164,35,71,106,89,0,89,0,17,840,714,0,644,70,126,214,9.7,5.6,16.0,15.0,300138.8046875,2843.0886138117894
49896,11102,11102,36081009500,164511,0,Census Tract 95,New York,Queens County,1322,1959,1411,1337,0,1244,78,15,74,74,0,69,5,0,548,444,0,399,45,104,119,6.1,1.1,0.0,19.0,287145.4609375,2430.46668646526
49897,11417,11417,36081009600,206470,0,Census Tract 96,New York,Queens County,1766,3102,2024,1908,0,1595,171,142,116,116,0,116,0,0,1078,1018,0,920,98,60,202,6.5,7.4,0.0,5.6,359383.73046875,2645.20655297155
49897,11419,11419,36081009600,206470,0,Census Tract 96,New York,Queens County,1766,3102,2024,1908,0,1595,171,142,116,116,0,116,0,0,1078,1018,0,920,98,60,202,6.5,7.4,0.0,5.6,359383.73046875,2645.20655297155
49897,11420,11420,36081009600,206470,0,Census Tract 96,New York,Queens County,1766,3102,2024,1908,0,1595,171,142,116,116,0,116,0,0,1078,1018,0,920,98,60,202,6.5,7.4,0.0,5.6,359383.73046875,2645.20655297155
49898,11102,11102,36081009700,201806,0,Census Tract 97,New York,Queens County,2283,3089,2381,2292,0,2275,8,9,89,89,0,89,0,0,708,579,0,526,53,129,138,4.5,0.4,0.0,18.2,352265.734375,2527.30326307238
49898,11105,11105,36081009700,201806,0,Census Tract 97,New York,Queens County,2283,3089,2381,2292,0,2275,8,9,89,89,0,89,0,0,708,579,0,526,53,129,138,4.5,0.4,0.0,18.2,352265.734375,2527.30326307238
49899,11417,11417,36081009800,135751,0,Census Tract 98,New York,Queens County,1151,2111,1296,1177,0,1088,63,26,119,119,0,119,0,0,815,684,0,593,91,131,157,7.4,2.2,0.0,16.1,236319.078125,2745.1076152419896
49899,11419,11419,36081009800,135751,0,Census Tract 98,New York,Queens County,1151,2111,1296,1177,0,1088,63,26,119,119,0,119,0,0,815,684,0,593,91,131,157,7.4,2.2,0.0,16.1,236319.078125,2745.1076152419896
49900,11102,11102,36081009900,249218,0,Census Tract 99,New York,Queens County,0,0,0,0,0,0,0,0,0,0,0,0,0,0,0,0,0,0,0,0,0,,,,,431671.6484375,3399.3828129935805
49901,11419,11419,36081010000,223353,0,Census Tract 100,New York,Queens County,1803,3289,2047,1842,0,1794,9,39,205,195,0,195,0,10,1242,1110,0,1101,9,132,181,5.5,2.1,4.9,10.6,388773.1796875,3059.93589654378
49901,11420,11420,36081010000,223353,0,Census Tract 100,New York,Queens County,1803,3289,2047,1842,0,1794,9,39,205,195,0,195,0,10,1242,1110,0,1101,9,132,181,5.5,2.1,4.9,10.6,388773.1796875,3059.93589654378
49902,11105,11105,36081010100,172758,0,Census Tract 101,New York,Queens County,1494,2135,1590,1531,0,1353,141,37,59,59,0,59,0,0,545,441,20,364,57,104,141,6.6,2.4,0.0,19.1,301581.859375,2407.40685995547
49903,11420,11420,36081010200,213860,0,Census Tract 102,New York,Queens County,1338,2441,1537,1338,5,1313,20,0,199,199,0,189,10,0,904,864,5,784,75,40,40,1.6,0.0,0.0,4.4,372224.6875,2827.93266487692
49904,11105,11105,36081010300,250464,0,Census Tract 103,New York,Queens County,2350,3512,2573,2424,0,2255,95,74,149,149,0,149,0,0,939,696,0,649,47,243,317,9.0,3.1,0.0,25.9,437266.65625,3737.51335836524
49905,11419,11419,36081010400,186476,0,Census Tract 104,New York,Queens County,1824,2881,2037,1869,13,1708,103,45,168,168,0,168,0,0,844,772,0,724,48,72,117,4.1,2.4,0.0,8.5,324600.9375,2710.5347272960003
49905,11420,11420,36081010400,186476,0,Census Tract 104,New York,Queens County,1824,2881,2037,1869,13,1708,103,45,168,168,0,168,0,0,844,772,0,724,48,72,117,4.1,2.4,0.0,8.5,324600.9375,2710.5347272960003
49906,11105,11105,36081010500,198021,0,Census Tract 105,New York,Queens County,1961,3534,2218,2022,0,1943,18,61,196,166,0,166,0,30,1316,1094,0,976,118,222,313,8.9,3.0,15.3,16.9,345727.01171875,2669.1362959125304
49907,11419,11419,36081010600,173008,0,Census Tract 106,New York,Queens County,1913,3287,2190,1934,0,1815,98,21,256,251,0,251,0,5,1097,972,0,895,77,125,151,4.6,1.1,2.0,11.4,301181.0703125,3559.86446976802
49907,11420,11420,36081010600,173008,0,Census Tract 106,New York,Queens County,1913,3287,2190,1934,0,1815,98,21,256,251,0,251,0,5,1097,972,0,895,77,125,151,4.6,1.1,2.0,11.4,301181.0703125,3559.86446976802
49908,11105,11105,36081010701,1600761,1367482,Census Tract 107.01,New York,Queens County,0,0,0,0,0,0,0,0,0,0,0,0,0,0,0,0,0,0,0,0,0,,,,,2477157.81640625,12590.6886756077
49909,11419,11419,36081010800,157581,0,Census Tract 108,New York,Queens County,1540,2752,1880,1678,0,1525,15,138,202,195,0,195,0,7,872,811,0,811,0,61,206,7.5,8.2,3.5,7.0,274350.08203125,2410.7516702401
49910,11416,11416,36081011000,165044,0,Census Tract 110,New York,Queens County,1751,2706,1909,1812,0,1507,244,61,97,88,0,88,0,9,797,714,0,669,45,83,153,5.7,3.4,9.3,10.4,287332.7265625,2601.59257309254
49910,11419,11419,36081011000,165044,0,Census Tract 110,New York,Queens County,1751,2706,1909,1812,0,1507,244,61,97,88,0,88,0,9,797,714,0,669,45,83,153,5.7,3.4,9.3,10.4,287332.7265625,2601.59257309254
49911,11105,11105,36081011100,150737,0,Census Tract 111,New York,Queens County,1737,2737,1943,1824,9,1703,25,87,119,119,0,119,0,0,794,677,0,637,40,117,204,7.5,4.8,0.0,14.7,263141.7421875,2193.8209792525304
49912,11416,11416,36081011200,189192,0,Census Tract 112,New York,Queens County,762,1691,920,811,0,762,0,49,109,109,0,99,10,0,771,529,0,493,36,242,291,17.2,6.0,0.0,31.4,329340.67578125,2579.48844398542
49912,11417,11417,36081011200,189192,0,Census Tract 112,New York,Queens County,762,1691,920,811,0,762,0,49,109,109,0,99,10,0,771,529,0,493,36,242,291,17.2,6.0,0.0,31.4,329340.67578125,2579.48844398542
49913,11105,11105,36081011300,178676,0,Census Tract 113,New York,Queens County,2697,3919,2893,2757,13,2602,82,60,136,136,0,136,0,0,1026,846,29,740,77,180,240,6.1,2.2,0.0,17.5,311891.31640625,2436.57547409931
49914,11416,11416,36081011400,119157,0,Census Tract 114,New York,Queens County,535,932,636,553,0,451,84,18,83,83,0,65,18,0,296,250,33,194,23,46,64,6.9,3.3,0.0,15.5,207448.09765625,2007.4928441004602
49915,11105,11105,36081011500,185559,0,Census Tract 115,New York,Queens County,1675,2269,1722,1697,0,1675,0,22,25,25,0,25,0,0,547,422,0,380,42,125,147,6.5,1.3,0.0,22.9,323884.41796875,2379.1735298827302
49916,11416,11416,36081011600,136941,0,Census Tract 116,New York,Queens County,1185,1802,1305,1242,0,1127,58,57,63,53,0,53,0,10,497,459,0,448,11,38,105,5.8,4.6,15.9,7.6,238418.21875,2315.61361619433
49917,11105,11105,36081011700,212827,0,Census Tract 117,New York,Queens County,2312,3405,2486,2435,9,2213,90,123,51,41,0,41,0,10,919,703,11,692,0,216,349,10.2,5.1,19.6,23.5,371457.46875,2562.94037019664
49918,11419,11419,36081011800,157088,0,Census Tract 118,New York,Queens County,1271,2069,1384,1278,0,1188,83,7,106,106,0,91,15,0,685,654,0,608,46,31,38,1.8,0.5,0.0,4.5,273505.3828125,3128.9201661249895
49919,11105,11105,36081011900,111475,0,Census Tract 119,New York,Queens County,931,1294,982,939,0,891,40,8,43,43,0,43,0,0,312,192,0,187,5,120,128,9.9,0.9,0.0,38.5,194556.8828125,1807.24882546161
49920,11419,11419,36081012000,144523,0,Census Tract 120,New York,Queens County,965,1868,1173,1023,0,837,128,58,150,139,0,69,70,11,695,559,0,440,119,136,205,11.0,5.7,7.3,19.6,251637.8046875,2060.4224802418
49921,11105,11105,36081012100,137900,0,Census Tract 121,New York,Queens County,1264,1885,1411,1366,0,1226,38,102,45,37,0,37,0,8,474,388,0,369,19,86,196,10.4,7.5,17.8,18.1,240688.640625,2045.8280872776897
49922,11418,11418,36081012200,210185,0,Census Tract 122,New York,Queens County,1659,2737,1773,1667,0,1500,159,8,106,106,0,72,34,0,964,901,0,825,76,63,71,2.6,0.5,0.0,6.5,366017.40234375,2625.8099088538897
49923,11105,11105,36081012301,591516,0,Census Tract 123.01,New York,Queens County,1627,2532,1784,1685,0,1512,115,58,99,99,0,99,0,0,748,607,0,464,143,141,199,7.9,3.4,0.0,18.9,1032516.546875,4839.11407316623
49923,11370,11370,36081012301,591516,0,Census Tract 123.01,New York,Queens County,1627,2532,1784,1685,0,1512,115,58,99,99,0,99,0,0,748,607,0,464,143,141,199,7.9,3.4,0.0,18.9,1032516.546875,4839.11407316623
49924,11418,11418,36081012400,197659,0,Census Tract 124,New York,Queens County,1353,2272,1541,1446,0,1210,143,93,95,95,6,80,9,0,731,704,0,593,111,27,120,5.3,6.4,0.0,3.7,344195.65625,2488.88383236257
49925,11102,11102,36081012500,163049,0,Census Tract 125,New York,Queens County,1135,1625,1198,1139,0,1026,109,4,59,59,0,51,8,0,427,376,0,350,26,51,55,3.4,0.4,0.0,11.9,284568.39453125,2834.95562008567
49925,11103,11103,36081012500,163049,0,Census Tract 125,New York,Queens County,1135,1625,1198,1139,0,1026,109,4,59,59,0,51,8,0,427,376,0,350,26,51,55,3.4,0.4,0.0,11.9,284568.39453125,2834.95562008567
49926,11418,11418,36081012601,150189,0,Census Tract 126.01,New York,Queens County,1441,2387,1546,1441,0,1378,63,0,105,105,0,97,8,0,841,809,0,753,56,32,32,1.3,0.0,0.0,3.8,261520.41796875,2340.21481840714
49927,11418,11418,36081012602,148974,0,Census Tract 126.02,New York,Queens County,1273,2119,1417,1339,0,1212,61,66,78,78,0,78,0,0,702,662,0,616,46,40,106,5.0,4.9,0.0,5.7,259402.47265625,2266.62576233443
49928,11418,11418,36081012800,159250,0,Census Tract 128,New York,Queens County,1117,1757,1183,1122,0,1076,41,5,61,56,0,50,6,5,574,518,9,509,0,56,66,3.8,0.4,8.2,9.8,277337.25,2338.83828631651
49929,11418,11418,36081013000,187692,0,Census Tract 130,New York,Queens County,681,1238,741,701,0,652,29,20,40,40,0,40,0,0,497,384,0,384,0,113,133,10.7,2.9,0.0,22.7,326886.86328125,3113.01132591181
49930,11415,11415,36081013200,192356,0,Census Tract 132,New York,Queens County,1010,1702,1108,1037,15,986,9,27,71,71,0,71,0,0,594,502,0,481,21,92,119,7.0,2.6,0.0,15.5,335020.0,2683.53522135888
49930,11418,11418,36081013200,192356,0,Census Tract 132,New York,Queens County,1010,1702,1108,1037,15,986,9,27,71,71,0,71,0,0,594,502,0,481,21,92,119,7.0,2.6,0.0,15.5,335020.0,2683.53522135888
49931,11415,11415,36081013400,190808,0,Census Tract 134,New York,Queens County,2770,4206,2920,2770,0,2600,170,0,150,150,0,150,0,0,1286,1015,0,816,199,271,271,6.4,0.0,0.0,21.1,332362.8828125,2634.59375811183
49931,11418,11418,36081013400,190808,0,Census Tract 134,New York,Queens County,2770,4206,2920,2770,0,2600,170,0,150,150,0,150,0,0,1286,1015,0,816,199,271,271,6.4,0.0,0.0,21.1,332362.8828125,2634.59375811183
49932,11105,11105,36081013500,135758,0,Census Tract 135,New York,Queens County,709,1300,763,716,0,682,27,7,47,47,0,47,0,0,537,408,5,352,51,129,136,10.5,1.0,0.0,24.0,236935.38671875,2311.2336249898003
49932,11370,11370,36081013500,135758,0,Census Tract 135,New York,Queens County,709,1300,763,716,0,682,27,7,47,47,0,47,0,0,537,408,5,352,51,129,136,10.5,1.0,0.0,24.0,236935.38671875,2311.2336249898003
49933,11415,11415,36081013600,151408,0,Census Tract 136,New York,Queens County,1034,1648,1073,1040,0,973,61,6,33,33,0,33,0,0,575,499,0,441,58,76,82,5.0,0.6,0.0,13.2,263740.890625,2404.85307372461
49934,11105,11105,36081013700,199933,0,Census Tract 137,New York,Queens County,1052,1542,1104,1068,0,980,72,16,36,24,0,24,0,12,438,370,0,338,32,68,96,6.2,1.5,33.3,15.5,348917.32421875,3168.9854435589195
49935,11415,11415,36081013800,169755,0,Census Tract 138,New York,Queens County,1766,2900,2068,1986,0,1573,193,220,82,62,0,62,0,20,832,732,12,558,162,100,340,11.7,11.1,24.4,12.0,295704.95703125,3273.63939238015
49935,11418,11418,36081013800,169755,0,Census Tract 138,New York,Queens County,1766,2900,2068,1986,0,1573,193,220,82,62,0,62,0,20,832,732,12,558,162,100,340,11.7,11.1,24.4,12.0,295704.95703125,3273.63939238015
49936,11415,11415,36081014000,222107,0,Census Tract 140,New York,Queens County,1864,2953,1929,1899,0,1670,194,35,30,30,0,30,0,0,1024,962,9,829,124,62,97,3.3,1.8,0.0,6.1,386862.828125,2933.8042591562703
49936,11418,11418,36081014000,222107,0,Census Tract 140,New York,Queens County,1864,2953,1929,1899,0,1670,194,35,30,30,0,30,0,0,1024,962,9,829,124,62,97,3.3,1.8,0.0,6.1,386862.828125,2933.8042591562703
49937,11103,11103,36081014100,171071,0,Census Tract 141,New York,Queens County,1079,1555,1254,1176,0,1020,59,97,78,78,0,78,0,0,301,267,0,210,57,34,131,8.4,8.2,0.0,11.3,298531.97265625,2616.40829179933
49937,11377,11377,36081014100,171071,0,Census Tract 141,New York,Queens County,1079,1555,1254,1176,0,1020,59,97,78,78,0,78,0,0,301,267,0,210,57,34,131,8.4,8.2,0.0,11.3,298531.97265625,2616.40829179933
49938,11418,11418,36081014201,210913,0,Census Tract 142.01,New York,Queens County,2022,3330,2229,2150,0,1883,139,128,79,79,0,79,0,0,1101,1038,0,944,94,63,191,5.7,6.0,0.0,5.7,367337.7734375,2540.19376671159
49939,11418,11418,36081014202,618133,0,Census Tract 142.02,New York,Queens County,1176,2000,1288,1202,0,1056,120,26,86,86,0,86,0,0,712,628,0,509,119,84,110,5.5,2.2,0.0,11.8,1076496.09375,4980.164008008979
49939,11419,11419,36081014202,618133,0,Census Tract 142.02,New York,Queens County,1176,2000,1288,1202,0,1056,120,26,86,86,0,86,0,0,712,628,0,509,119,84,110,5.5,2.2,0.0,11.8,1076496.09375,4980.164008008979
49940,11103,11103,36081014300,136506,0,Census Tract 143,New York,Queens County,2262,3465,2563,2357,0,2191,71,95,206,206,0,206,0,0,902,771,0,705,66,131,226,6.5,4.0,0.0,14.5,238209.17578125,2180.82517119378
49941,11418,11418,36081014400,219829,0,Census Tract 144,New York,Queens County,856,1477,882,856,0,783,73,0,26,26,0,26,0,0,595,568,0,496,72,27,27,1.8,0.0,0.0,4.5,382833.53125,3157.33257527886
49942,11103,11103,36081014500,127735,0,Census Tract 145,New York,Queens County,1107,1895,1237,1114,0,1016,91,7,123,123,0,117,6,0,658,519,0,444,75,139,146,7.7,0.6,0.0,21.1,222889.65234375,1897.65192096883
49943,11103,11103,36081014700,147950,0,Census Tract 147,New York,Queens County,1755,2791,1921,1800,0,1663,92,45,121,108,0,108,0,13,870,662,17,586,59,208,266,9.5,2.5,10.7,23.9,258153.73046875,2431.89071660957
49944,11419,11419,36081014800,157056,0,Census Tract 148,New York,Queens County,890,1629,1066,939,0,882,8,49,127,127,0,115,12,0,563,478,0,440,38,85,134,8.2,5.2,0.0,15.1,273486.9765625,3198.22728768944
49945,11103,11103,36081014900,106596,0,Census Tract 149,New York,Queens County,1119,1750,1310,1209,9,1110,0,90,101,101,0,101,0,0,440,378,0,358,20,62,152,8.7,7.4,0.0,14.1,185990.18359375,1725.35130993034
49946,11419,11419,36081015000,147117,0,Census Tract 150,New York,Queens County,1229,2294,1365,1272,0,1118,111,43,93,85,0,85,0,8,929,858,0,750,108,71,122,5.3,3.4,8.6,7.6,256168.0390625,3103.22488605206
49947,11103,11103,36081015100,133431,0,Census Tract 151,New York,Queens County,1502,2170,1635,1530,0,1431,71,28,105,105,0,105,0,0,535,438,0,330,108,97,125,5.8,1.8,0.0,18.1,232800.6953125,1936.6898951109301
49948,11419,11419,36081015200,185295,0,Census Tract 152,New York,Queens County,1356,2352,1462,1376,0,1265,91,20,86,81,0,72,9,5,890,820,0,780,40,70,95,4.0,1.5,5.8,7.9,322649.859375,2694.76537175054
49949,11103,11103,36081015300,121629,0,Census Tract 153,New York,Queens County,1277,1690,1332,1300,0,1212,65,23,32,32,0,32,0,0,358,243,0,226,17,115,138,8.2,1.8,0.0,32.1,212197.0,1857.96026439637
49950,11419,11419,36081015400,150144,0,Census Tract 154,New York,Queens County,1156,2017,1384,1235,0,1073,83,79,149,136,0,127,9,13,633,592,0,547,45,41,133,6.6,6.4,8.7,6.5,261427.54296875,3113.03080556942
49951,11103,11103,36081015500,147508,0,Census Tract 155,New York,Queens County,1643,2136,1723,1662,0,1580,63,19,61,61,0,61,0,0,413,380,0,369,11,33,52,2.4,1.1,0.0,8.0,257360.4140625,3326.93825515845
49952,11419,11419,36081015600,209476,0,Census Tract 156,New York,Queens County,1383,2399,1533,1448,0,1317,66,65,85,85,0,85,0,0,866,788,0,767,21,78,143,6.0,4.5,0.0,9.0,364719.4609375,2951.4610940566804
49953,11101,11101,36081015700,128464,0,Census Tract 157,New York,Queens County,776,1181,860,815,11,675,90,39,45,45,0,18,27,0,321,272,0,234,38,49,88,7.5,4.8,0.0,15.3,224100.84765625,2917.2668632990503
49953,11103,11103,36081015700,128464,0,Census Tract 157,New York,Queens County,776,1181,860,815,11,675,90,39,45,45,0,18,27,0,321,272,0,234,38,49,88,7.5,4.8,0.0,15.3,224100.84765625,2917.2668632990503
49954,11419,11419,36081015801,295609,0,Census Tract 158.01,New York,Queens County,1549,2718,1832,1584,8,1407,134,35,248,225,0,194,31,23,886,859,42,773,44,27,85,3.1,2.2,9.3,3.0,514661.08984375,3119.7752532803197
49955,11419,11419,36081015802,278405,0,Census Tract 158.02,New York,Queens County,2318,3996,2701,2479,9,2159,150,161,222,201,0,175,26,21,1295,1144,9,1093,42,151,333,8.3,6.5,9.5,11.7,484689.17578125,3114.9369882557003
49956,11101,11101,36081015900,169679,0,Census Tract 159,New York,Queens County,2184,3183,2328,2223,0,2052,132,39,105,105,0,105,0,0,855,692,0,662,30,163,202,6.3,1.8,0.0,19.1,296006.74609375,2439.1645501992
49956,11103,11103,36081015900,169679,0,Census Tract 159,New York,Queens County,2184,3183,2328,2223,0,2052,132,39,105,105,0,105,0,0,855,692,0,662,30,163,202,6.3,1.8,0.0,19.1,296006.74609375,2439.1645501992
49957,11101,11101,36081016100,107696,0,Census Tract 161,New York,Queens County,1149,1941,1383,1233,0,1112,37,84,150,150,0,140,10,0,558,456,0,400,56,102,186,9.6,6.8,0.0,18.3,187871.2890625,1813.0211305531898
49957,11103,11103,36081016100,107696,0,Census Tract 161,New York,Queens County,1149,1941,1383,1233,0,1112,37,84,150,150,0,140,10,0,558,456,0,400,56,102,186,9.6,6.8,0.0,18.3,187871.2890625,1813.0211305531898
49958,11101,11101,36081016300,218253,0,Census Tract 163,New York,Queens County,1005,3122,1213,1098,0,793,212,93,115,115,0,115,0,0,1909,1381,0,1019,362,528,621,19.9,8.5,0.0,27.7,380751.13671875,3113.02767511573
49958,11103,11103,36081016300,218253,0,Census Tract 163,New York,Queens County,1005,3122,1213,1098,0,793,212,93,115,115,0,115,0,0,1909,1381,0,1019,362,528,621,19.9,8.5,0.0,27.7,380751.13671875,3113.02767511573
49958,11377,11377,36081016300,218253,0,Census Tract 163,New York,Queens County,1005,3122,1213,1098,0,793,212,93,115,115,0,115,0,0,1909,1381,0,1019,362,528,621,19.9,8.5,0.0,27.7,380751.13671875,3113.02767511573
49959,11419,11419,36081016400,197820,0,Census Tract 164,New York,Queens County,1746,3058,1968,1773,19,1677,50,27,195,195,0,182,13,0,1090,983,32,839,112,107,134,4.4,1.5,0.0,9.8,344369.2890625,2751.13208195594
49960,11419,11419,36081016600,202884,0,Census Tract 166,New York,Queens County,2019,3433,2200,2085,0,1791,228,66,115,115,0,100,15,0,1233,1015,0,952,63,218,284,8.3,3.2,0.0,17.7,353146.37109375,3778.0684900615797
49960,11420,11420,36081016600,202884,0,Census Tract 166,New York,Queens County,2019,3433,2200,2085,0,1791,228,66,115,115,0,100,15,0,1233,1015,0,952,63,218,284,8.3,3.2,0.0,17.7,353146.37109375,3778.0684900615797
49961,11420,11420,36081016800,211385,0,Census Tract 168,New York,Queens County,1424,2653,1543,1458,0,1364,60,34,85,85,0,85,0,0,1110,969,0,921,48,141,175,6.6,2.3,0.0,12.7,367916.44140625,3013.5415743556396
49962,11104,11104,36081016900,231080,0,Census Tract 169,New York,Queens County,3185,5129,3390,3185,0,2945,240,0,205,205,0,162,43,0,1739,1383,20,1195,168,356,356,6.9,0.0,0.0,20.5,403027.46484375,2969.15730357605
49962,11377,11377,36081016900,231080,0,Census Tract 169,New York,Queens County,3185,5129,3390,3185,0,2945,240,0,205,205,0,162,43,0,1739,1383,20,1195,168,356,356,6.9,0.0,0.0,20.5,403027.46484375,2969.15730357605
49963,11420,11420,36081017000,217461,0,Census Tract 170,New York,Queens County,1185,2192,1380,1247,0,1171,14,62,133,133,0,133,0,0,812,734,0,715,19,78,140,6.4,5.0,0.0,9.6,378550.4609375,3077.1039964304805
49964,11101,11101,36081017100,1248954,0,Census Tract 171,New York,Queens County,0,0,0,0,0,0,0,0,0,0,0,0,0,0,0,0,0,0,0,0,0,,,,,2178415.50390625,9294.817072078129
49964,11104,11104,36081017100,1248954,0,Census Tract 171,New York,Queens County,0,0,0,0,0,0,0,0,0,0,0,0,0,0,0,0,0,0,0,0,0,,,,,2178415.50390625,9294.817072078129
49965,11420,11420,36081017200,191064,0,Census Tract 172,New York,Queens County,1049,1804,1107,1057,0,962,87,8,50,50,0,50,0,0,697,619,0,600,19,78,86,4.8,0.8,0.0,11.2,332582.609375,2977.79113595849
49966,11420,11420,36081017400,190574,0,Census Tract 174,New York,Queens County,1155,2043,1282,1186,0,1115,40,31,96,88,0,57,31,8,761,645,0,578,67,116,155,7.6,2.6,8.3,15.2,331713.9453125,2969.0264752077
49967,11420,11420,36081017600,189834,0,Census Tract 176,New York,Queens County,1077,1811,1234,1095,20,999,58,18,139,139,0,133,6,0,577,489,13,405,71,88,106,5.9,1.6,0.0,15.3,330409.515625,2958.67940035999
49968,11420,11420,36081017800,188705,0,Census Tract 178,New York,Queens County,1027,1821,1139,1083,0,932,95,56,56,56,0,46,10,0,682,602,0,566,36,80,136,7.5,5.2,0.0,11.7,328420.4453125,3013.0252260051
49969,11101,11101,36081017900,473761,0,Census Tract 179,New York,Queens County,599,927,679,612,0,556,43,13,67,67,0,67,0,0,248,235,0,172,63,13,26,2.8,2.1,0.0,5.2,826208.24609375,4010.28947374284
49969,11104,11104,36081017900,473761,0,Census Tract 179,New York,Queens County,599,927,679,612,0,556,43,13,67,67,0,67,0,0,248,235,0,172,63,13,26,2.8,2.1,0.0,5.2,826208.24609375,4010.28947374284
49970,11420,11420,36081018000,138242,0,Census Tract 180,New York,Queens County,419,1042,586,453,0,419,0,34,133,133,0,117,16,0,456,433,0,415,18,23,57,5.5,7.5,0.0,5.0,240588.3203125,2293.47544789129
49971,11104,11104,36081018101,96143,0,Census Tract 181.01,New York,Queens County,1854,2992,2089,2000,0,1814,40,146,89,89,0,89,0,0,903,663,0,657,6,240,386,12.9,7.3,0.0,26.6,167668.51171875,2026.48499924112
49972,11104,11104,36081018102,96555,0,Census Tract 181.02,New York,Queens County,2201,3163,2321,2241,0,2139,62,40,80,80,0,80,0,0,842,604,0,492,112,238,278,8.8,1.8,0.0,28.3,168384.23828125,2027.1459685666198
49973,11436,11436,36081018200,260745,0,Census Tract 182,New York,Queens County,1198,2045,1343,1204,0,983,215,6,139,139,0,109,30,0,702,648,0,548,100,54,60,2.9,0.5,0.0,7.7,453789.69921875,2870.81967590647
49974,11104,11104,36081018300,215023,0,Census Tract 183,New York,Queens County,3546,5402,3923,3697,0,3298,248,151,226,226,0,226,0,0,1479,1225,0,1024,201,254,405,7.5,4.1,0.0,17.2,374987.70703125,3002.89774134445
49974,11377,11377,36081018300,215023,0,Census Tract 183,New York,Queens County,3546,5402,3923,3697,0,3298,248,151,226,226,0,226,0,0,1479,1225,0,1024,201,254,405,7.5,4.1,0.0,17.2,374987.70703125,3002.89774134445
49975,11434,11434,36081018401,190347,0,Census Tract 184.01,New York,Queens County,1007,1689,1141,1040,0,942,65,33,101,101,0,68,33,0,548,482,0,434,48,66,99,5.9,3.2,0.0,12.0,331263.26953125,2792.27862598294
49975,11436,11436,36081018401,190347,0,Census Tract 184.01,New York,Queens County,1007,1689,1141,1040,0,942,65,33,101,101,0,68,33,0,548,482,0,434,48,66,99,5.9,3.2,0.0,12.0,331263.26953125,2792.27862598294
49976,11436,11436,36081018402,212544,0,Census Tract 184.02,New York,Queens County,1015,1717,1117,1029,0,973,42,14,88,88,0,81,7,0,600,512,0,438,74,88,102,5.9,1.4,0.0,14.7,369936.109375,2875.68358678849
49977,11104,11104,36081018501,98522,0,Census Tract 185.01,New York,Queens County,1816,2834,2068,2000,0,1718,98,184,68,55,0,55,0,13,766,635,20,567,48,131,328,11.6,9.2,19.1,17.1,171783.625,1801.75741062843
49977,11377,11377,36081018501,98522,0,Census Tract 185.01,New York,Queens County,1816,2834,2068,2000,0,1718,98,184,68,55,0,55,0,13,766,635,20,567,48,131,328,11.6,9.2,19.1,17.1,171783.625,1801.75741062843
49978,11104,11104,36081018502,98391,0,Census Tract 185.02,New York,Queens County,2091,3028,2255,2193,0,1907,184,102,62,62,0,53,9,0,773,698,0,639,59,75,177,5.8,4.7,0.0,9.7,171563.26953125,1801.2696180125897
49978,11377,11377,36081018502,98391,0,Census Tract 185.02,New York,Queens County,2091,3028,2255,2193,0,1907,184,102,62,62,0,53,9,0,773,698,0,639,59,75,177,5.8,4.7,0.0,9.7,171563.26953125,1801.2696180125897
49979,11436,11436,36081018600,180949,0,Census Tract 186,New York,Queens County,897,1574,1048,974,0,828,69,77,74,74,0,64,10,0,526,453,0,435,18,73,150,9.5,7.9,0.0,13.9,314949.76953125,2858.4682965165803
49980,11101,11101,36081018700,236444,0,Census Tract 187,New York,Queens County,1733,2584,1841,1807,0,1426,307,74,34,34,0,34,0,0,743,619,0,531,88,124,198,7.7,4.1,0.0,16.7,412241.4296875,3116.78605785493
49980,11104,11104,36081018700,236444,0,Census Tract 187,New York,Queens County,1733,2584,1841,1807,0,1426,307,74,34,34,0,34,0,0,743,619,0,531,88,124,198,7.7,4.1,0.0,16.7,412241.4296875,3116.78605785493
49980,11377,11377,36081018700,236444,0,Census Tract 187,New York,Queens County,1733,2584,1841,1807,0,1426,307,74,34,34,0,34,0,0,743,619,0,531,88,124,198,7.7,4.1,0.0,16.7,412241.4296875,3116.78605785493
49981,11436,11436,36081018800,178872,0,Census Tract 188,New York,Queens County,689,1094,781,727,0,625,64,38,54,54,0,54,0,0,313,279,0,234,45,34,72,6.6,5.2,0.0,10.9,311348.9296875,2817.02416754169
49982,11101,11101,36081018900,217707,0,Census Tract 189,New York,Queens County,1891,2897,2001,1936,0,1837,54,45,65,65,0,65,0,0,896,795,0,768,27,101,146,5.0,2.3,0.0,11.3,379611.94140625,2515.28005691771
49982,11104,11104,36081018900,217707,0,Census Tract 189,New York,Queens County,1891,2897,2001,1936,0,1837,54,45,65,65,0,65,0,0,896,795,0,768,27,101,146,5.0,2.3,0.0,11.3,379611.94140625,2515.28005691771
49983,11434,11434,36081019000,188259,0,Census Tract 190,New York,Queens County,1295,2071,1526,1374,0,1209,86,79,152,140,0,130,10,12,545,499,0,411,88,46,137,6.6,5.7,7.9,8.4,327732.125,2544.63255021168
49983,11435,11435,36081019000,188259,0,Census Tract 190,New York,Queens County,1295,2071,1526,1374,0,1209,86,79,152,140,0,130,10,12,545,499,0,411,88,46,137,6.6,5.7,7.9,8.4,327732.125,2544.63255021168
49983,11436,11436,36081019000,188259,0,Census Tract 190,New York,Queens County,1295,2071,1526,1374,0,1209,86,79,152,140,0,130,10,12,545,499,0,411,88,46,137,6.6,5.7,7.9,8.4,327732.125,2544.63255021168
49984,11435,11435,36081019200,201046,0,Census Tract 192,New York,Queens County,1097,1748,1228,1132,0,987,110,35,96,90,0,74,16,6,520,510,0,409,101,10,51,2.9,3.1,6.3,1.9,349972.6953125,3258.3843610643
49984,11436,11436,36081019200,201046,0,Census Tract 192,New York,Queens County,1097,1748,1228,1132,0,987,110,35,96,90,0,74,16,6,520,510,0,409,101,10,51,2.9,3.1,6.3,1.9,349972.6953125,3258.3843610643
49985,11435,11435,36081019400,305897,0,Census Tract 194,New York,Queens County,1392,2473,1601,1423,11,1280,101,31,178,178,0,178,0,0,872,766,4,695,67,106,137,5.5,2.2,0.0,12.2,532524.69140625,3149.41324510384
49986,11435,11435,36081019600,222897,0,Census Tract 196,New York,Queens County,1389,2351,1633,1389,0,1310,79,0,244,244,0,227,17,0,718,642,0,534,108,76,76,3.2,0.0,0.0,10.6,388077.3046875,3005.2785563580396
49987,11435,11435,36081019800,207719,0,Census Tract 198,New York,Queens County,1308,2398,1576,1360,0,1240,68,52,216,189,0,175,14,27,822,739,0,655,84,83,162,6.8,3.8,12.5,10.1,361676.5703125,2776.39055807909
49988,11101,11101,36081019900,1590839,87694,Census Tract 199,New York,Queens County,194,354,277,235,0,177,17,41,42,42,0,30,12,0,77,77,0,77,0,0,41,11.6,17.4,0.0,0.0,2713880.9375,8378.51631878045
49988,11378,11378,36081019900,1590839,87694,Census Tract 199,New York,Queens County,194,354,277,235,0,177,17,41,42,42,0,30,12,0,77,77,0,77,0,0,41,11.6,17.4,0.0,0.0,2713880.9375,8378.51631878045
49989,11435,11435,36081020200,153117,0,Census Tract 202,New York,Queens County,709,1314,936,709,0,667,42,0,227,216,0,216,0,11,378,375,0,369,6,3,14,1.1,0.0,4.8,0.8,266590.19140625,2390.62369439772
49990,11433,11433,36081020400,286644,0,Census Tract 204,New York,Queens County,1244,2002,1336,1254,18,1118,108,10,82,60,13,31,16,22,666,572,11,527,34,94,126,6.3,0.8,26.8,14.1,499145.26171875,3554.26556658974
49990,11435,11435,36081020400,286644,0,Census Tract 204,New York,Queens County,1244,2002,1336,1254,18,1118,108,10,82,60,13,31,16,22,666,572,11,527,34,94,126,6.3,0.8,26.8,14.1,499145.26171875,3554.26556658974
49991,11377,11377,36081020500,587633,0,Census Tract 205,New York,Queens County,628,983,701,664,0,535,93,36,37,37,0,29,8,0,282,269,0,209,60,13,49,5.0,5.4,0.0,4.6,1024339.6328125,4531.23267954665
49991,11378,11378,36081020500,587633,0,Census Tract 205,New York,Queens County,628,983,701,664,0,535,93,36,37,37,0,29,8,0,282,269,0,209,60,13,49,5.0,5.4,0.0,4.6,1024339.6328125,4531.23267954665
49992,11435,11435,36081020600,148614,0,Census Tract 206,New York,Queens County,907,1591,1033,939,0,859,48,32,94,80,0,80,0,14,558,511,0,484,27,47,93,5.8,3.4,14.9,8.4,258781.34765625,2431.66643512723
49993,11433,11433,36081020800,543966,0,Census Tract 208,New York,Queens County,1365,2115,1520,1387,0,1265,100,22,133,133,0,118,15,0,595,566,10,502,54,29,51,2.4,1.6,0.0,4.9,947326.78515625,4806.79989672531
49993,11435,11435,36081020800,543966,0,Census Tract 208,New York,Queens County,1365,2115,1520,1387,0,1265,100,22,133,133,0,118,15,0,595,566,10,502,54,29,51,2.4,1.6,0.0,4.9,947326.78515625,4806.79989672531
49994,11435,11435,36081021200,239054,0,Census Tract 212,New York,Queens County,815,1619,1074,989,0,686,129,174,85,79,0,67,12,6,545,474,0,444,30,71,251,15.5,17.6,7.1,13.0,416342.7578125,3320.24835229418
49995,11435,11435,36081021400,380752,0,Census Tract 214,New York,Queens County,3618,5960,4346,3778,0,3374,244,160,568,568,0,568,0,0,1614,1500,0,1372,128,114,274,4.6,4.2,0.0,7.1,663237.10546875,3459.97670990237
49996,11415,11415,36081021600,642793,0,Census Tract 216,New York,Queens County,2114,3364,2234,2123,9,2002,103,9,111,101,0,101,0,10,1130,928,10,760,158,202,221,6.6,0.4,9.0,17.9,1119800.13671875,6165.6595910593705
49996,11418,11418,36081021600,642793,0,Census Tract 216,New York,Queens County,2114,3364,2234,2123,9,2002,103,9,111,101,0,101,0,10,1130,928,10,760,158,202,221,6.6,0.4,9.0,17.9,1119800.13671875,6165.6595910593705
49996,11424,11415,36081021600,642793,0,Census Tract 216,New York,Queens County,2114,3364,2234,2123,9,2002,103,9,111,101,0,101,0,10,1130,928,10,760,158,202,221,6.6,0.4,9.0,17.9,1119800.13671875,6165.6595910593705
49997,11378,11378,36081021900,1283506,107995,Census Tract 219,New York,Queens County,0,0,0,0,0,0,0,0,0,0,0,0,0,0,0,0,0,0,0,0,0,,,,,2172125.26171875,9136.675270780559
49998,11435,11435,36081022001,395707,0,Census Tract 220.01,New York,Queens County,3660,5345,4116,3742,0,3429,231,82,374,374,0,220,154,0,1229,1092,0,991,101,137,219,4.1,2.2,0.0,11.1,689445.6328125,3632.13145971594
49999,11435,11435,36081022002,306106,0,Census Tract 220.02,New York,Queens County,3701,5853,4172,3805,0,3459,242,104,367,352,0,284,68,15,1681,1461,0,1264,197,220,339,5.8,2.7,4.1,13.1,533323.73828125,4348.01292405005
50000,11377,11377,36081022900,1341173,0,Census Tract 229,New York,Queens County,25,47,25,25,0,25,0,0,0,0,0,0,0,0,22,22,0,22,0,0,0,0.0,0.0,,0.0,2338178.22265625,8811.50882475855
50000,11378,11378,36081022900,1341173,0,Census Tract 229,New York,Queens County,25,47,25,25,0,25,0,0,0,0,0,0,0,0,22,22,0,22,0,0,0,0.0,0.0,,0.0,2338178.22265625,8811.50882475855
50001,11432,11432,36081023000,165801,0,Census Tract 230,New York,Queens County,1068,1730,1154,1068,0,1046,22,0,86,86,0,86,0,0,576,547,0,506,41,29,29,1.7,0.0,0.0,5.0,288869.76171875,2430.3371111704896
50001,11435,11435,36081023000,165801,0,Census Tract 230,New York,Queens County,1068,1730,1154,1068,0,1046,22,0,86,86,0,86,0,0,576,547,0,506,41,29,29,1.7,0.0,0.0,5.0,288869.76171875,2430.3371111704896
50002,11435,11435,36081023200,330470,0,Census Tract 232,New York,Queens County,2682,4250,2878,2744,9,2559,114,62,134,126,0,126,0,8,1372,1103,37,943,123,269,339,8.0,2.3,6.0,19.6,575710.9140625,3602.87773069896
50003,11104,11104,36081023500,255537,0,Census Tract 235,New York,Queens County,4266,6810,4619,4457,50,3857,359,191,162,162,0,162,0,0,2191,1695,16,1470,209,496,687,10.1,4.3,0.0,22.6,445563.39453125,3419.98988412625
50003,11377,11377,36081023500,255537,0,Census Tract 235,New York,Queens County,4266,6810,4619,4457,50,3857,359,191,162,162,0,162,0,0,2191,1695,16,1470,209,496,687,10.1,4.3,0.0,22.6,445563.39453125,3419.98988412625
50004,11432,11432,36081023600,176279,0,Census Tract 236,New York,Queens County,1581,2550,1705,1615,0,1356,225,34,90,90,0,77,13,0,845,770,0,686,84,75,109,4.3,2.1,0.0,8.9,307076.37890625,2300.5776239278302
50005,11435,11435,36081023800,156689,0,Census Tract 238,New York,Queens County,2239,3624,2524,2285,0,2049,190,46,239,239,0,221,18,0,1100,927,0,760,167,173,219,6.0,2.0,0.0,15.7,272929.76171875,2156.7449511479103
50006,11432,11432,36081024000,269563,0,Census Tract 240,New York,Queens County,2635,4740,3139,2743,0,2341,294,108,396,375,0,292,83,21,1601,1277,0,1171,106,324,453,9.6,3.9,5.3,20.2,469518.7890625,3215.9930953832
50006,11435,11435,36081024000,269563,0,Census Tract 240,New York,Queens County,2635,4740,3139,2743,0,2341,294,108,396,375,0,292,83,21,1601,1277,0,1171,106,324,453,9.6,3.9,5.3,20.2,469518.7890625,3215.9930953832
50007,11377,11377,36081024300,540125,0,Census Tract 243,New York,Queens County,2722,4709,2924,2793,0,2535,187,71,131,131,0,118,13,0,1785,1534,0,1415,119,251,322,6.8,2.5,0.0,14.1,941712.9453125,5217.242072826621
50008,11377,11377,36081024500,257660,0,Census Tract 245,New York,Queens County,2721,4453,2805,2757,0,2631,90,36,48,48,0,48,0,0,1648,1327,0,1232,95,321,357,8.0,1.3,0.0,19.5,449270.1484375,3075.1016933518395
50009,11433,11433,36081024600,303539,0,Census Tract 246,New York,Queens County,0,0,0,0,0,0,0,0,0,0,0,0,0,0,0,0,0,0,0,0,0,,,,,528660.6328125,3139.8052772266997
50009,11451,11433,36081024600,303539,0,Census Tract 246,New York,Queens County,0,0,0,0,0,0,0,0,0,0,0,0,0,0,0,0,0,0,0,0,0,,,,,528660.6328125,3139.8052772266997
50010,11377,11377,36081024700,97621,0,Census Tract 247,New York,Queens County,749,1243,785,768,0,622,127,19,17,4,0,4,0,13,458,375,0,326,49,83,115,9.3,2.5,76.5,18.1,170229.3515625,1852.7421855182897
50011,11377,11377,36081024900,204083,0,Census Tract 249,New York,Queens County,2384,3987,2592,2458,0,2354,30,74,134,134,0,134,0,0,1395,1166,0,1151,15,229,303,7.6,3.0,0.0,16.4,355892.671875,2374.92112267384
50012,11377,11377,36081025100,245619,0,Census Tract 251,New York,Queens County,3177,5132,3308,3177,0,3104,73,0,131,131,0,131,0,0,1824,1668,13,1614,41,156,156,3.0,0.0,0.0,8.6,428340.53125,2980.0798553434697
50013,11104,11104,36081025301,127194,0,Census Tract 253.01,New York,Queens County,2457,3719,2798,2612,0,2316,141,155,186,178,0,178,0,8,921,776,0,752,24,145,308,8.3,5.9,4.3,15.7,221812.109375,1900.2376070476898
50013,11377,11377,36081025301,127194,0,Census Tract 253.01,New York,Queens County,2457,3719,2798,2612,0,2316,141,155,186,178,0,178,0,8,921,776,0,752,24,145,308,8.3,5.9,4.3,15.7,221812.109375,1900.2376070476898
50014,11377,11377,36081025302,105029,0,Census Tract 253.02,New York,Queens County,1884,2583,2059,2002,0,1719,165,118,57,57,0,57,0,0,524,492,0,418,74,32,150,5.8,5.9,0.0,6.1,183158.78515625,1753.4893392930999
50015,11433,11433,36081025400,632107,0,Census Tract 254,New York,Queens County,3579,8042,4691,3950,0,3099,480,371,741,731,0,653,78,10,3351,2546,0,1995,551,805,1186,14.7,9.4,1.3,24.0,1100773.41796875,4900.25902180576
50015,11435,11435,36081025400,632107,0,Census Tract 254,New York,Queens County,3579,8042,4691,3950,0,3099,480,371,741,731,0,653,78,10,3351,2546,0,1995,551,805,1186,14.7,9.4,1.3,24.0,1100773.41796875,4900.25902180576
50016,11377,11377,36081025500,218248,0,Census Tract 255,New York,Queens County,685,1200,803,731,0,616,69,46,72,72,0,72,0,0,397,332,0,290,42,65,111,9.3,6.3,0.0,16.4,380667.546875,3039.73993089171
50017,11377,11377,36081025700,150587,0,Census Tract 257,New York,Queens County,898,1313,957,929,0,809,89,31,28,19,0,19,0,9,356,314,0,281,33,42,82,6.2,3.3,32.1,11.8,262653.5390625,3187.92673559203
50018,11433,11433,36081025800,211843,0,Census Tract 258,New York,Queens County,953,1905,1144,964,0,802,151,11,180,180,0,165,15,0,761,750,0,551,199,11,22,1.2,1.1,0.0,1.4,368902.76953125,2452.8892949431
50019,11377,11377,36081025900,187189,0,Census Tract 259,New York,Queens County,1614,2969,1864,1774,0,1563,51,160,90,81,0,71,10,9,1105,905,0,880,25,200,369,12.4,9.0,10.0,18.1,326482.66015625,2694.56979316822
50020,11433,11433,36081026000,178376,0,Census Tract 260,New York,Queens County,953,1808,1205,983,0,762,191,30,222,215,0,177,38,7,603,579,0,479,100,24,61,3.4,3.1,3.2,4.0,310592.3125,3147.9804362382897
50020,11435,11435,36081026000,178376,0,Census Tract 260,New York,Queens County,953,1808,1205,983,0,762,191,30,222,215,0,177,38,7,603,579,0,479,100,24,61,3.4,3.1,3.2,4.0,310592.3125,3147.9804362382897
50021,11377,11377,36081026100,221607,0,Census Tract 261,New York,Queens County,3251,5740,3708,3500,31,2959,261,249,208,208,14,194,0,0,2032,1795,0,1534,261,237,486,8.5,7.1,0.0,11.7,386491.109375,2655.47366301455
50022,11433,11433,36081026200,143393,0,Census Tract 262,New York,Queens County,544,947,656,586,0,486,58,42,70,58,0,58,0,12,291,227,0,211,16,64,118,12.5,7.2,17.1,22.0,249667.60546875,2499.98504659297
50022,11435,11435,36081026200,143393,0,Census Tract 262,New York,Queens County,544,947,656,586,0,486,58,42,70,58,0,58,0,12,291,227,0,211,16,64,118,12.5,7.2,17.1,22.0,249667.60546875,2499.98504659297
50023,11377,11377,36081026300,196984,0,Census Tract 263,New York,Queens County,2950,5122,3216,3037,0,2724,226,87,179,179,0,179,0,0,1906,1839,0,1756,83,67,154,3.0,2.9,0.0,3.5,343534.66796875,2403.28815893517
50024,11433,11433,36081026400,254449,0,Census Tract 264,New York,Queens County,1097,2056,1298,1114,0,952,145,17,184,184,0,117,67,0,758,642,0,417,225,116,133,6.5,1.5,0.0,15.3,443049.41015625,3438.01576018868
50025,11372,11372,36081026500,188404,0,Census Tract 265,New York,Queens County,2153,3309,2316,2246,0,2027,126,93,70,59,0,59,0,11,993,848,0,838,10,145,249,7.5,4.1,15.7,14.6,328562.61328125,2798.59339500922
50025,11377,11377,36081026500,188404,0,Census Tract 265,New York,Queens County,2153,3309,2316,2246,0,2027,126,93,70,59,0,59,0,11,993,848,0,838,10,145,249,7.5,4.1,15.7,14.6,328562.61328125,2798.59339500922
50026,11433,11433,36081026600,172997,0,Census Tract 266,New York,Queens County,550,1430,737,626,0,385,165,76,111,111,0,96,15,0,693,441,0,273,168,252,328,22.9,12.1,0.0,36.4,301217.1171875,2568.5229211701003
50026,11434,11434,36081026600,172997,0,Census Tract 266,New York,Queens County,550,1430,737,626,0,385,165,76,111,111,0,96,15,0,693,441,0,273,168,252,328,22.9,12.1,0.0,36.4,301217.1171875,2568.5229211701003
50027,11372,11372,36081026700,209800,0,Census Tract 267,New York,Queens County,2996,4858,3592,3425,0,2567,429,429,167,167,0,139,28,0,1266,1101,0,950,151,165,594,12.2,12.5,0.0,13.0,365882.9609375,2582.0119536801603
50027,11373,11373,36081026700,209800,0,Census Tract 267,New York,Queens County,2996,4858,3592,3425,0,2567,429,429,167,167,0,139,28,0,1266,1101,0,950,151,165,594,12.2,12.5,0.0,13.0,365882.9609375,2582.0119536801603
50028,11372,11372,36081026901,114214,0,Census Tract 269.01,New York,Queens County,2817,4096,2959,2876,0,2776,41,59,83,54,0,54,0,29,1137,987,0,894,93,150,238,5.8,2.1,34.9,13.2,199192.171875,2239.69359636038
50028,11373,11373,36081026901,114214,0,Census Tract 269.01,New York,Queens County,2817,4096,2959,2876,0,2776,41,59,83,54,0,54,0,29,1137,987,0,894,93,150,238,5.8,2.1,34.9,13.2,199192.171875,2239.69359636038
50029,11373,11373,36081026902,78481,0,Census Tract 269.02,New York,Queens County,1797,2871,2015,1898,0,1489,308,101,117,117,0,79,38,0,856,737,0,694,43,119,220,7.7,5.3,0.0,13.9,136863.29296875,1489.74207469287
50030,11433,11433,36081027000,185068,0,Census Tract 270,New York,Queens County,822,1618,1076,851,0,778,44,29,225,225,0,225,0,0,542,497,0,464,33,45,74,4.6,3.4,0.0,8.3,322205.28125,2541.42641242412
50030,11434,11434,36081027000,185068,0,Census Tract 270,New York,Queens County,822,1618,1076,851,0,778,44,29,225,225,0,225,0,0,542,497,0,464,33,45,74,4.6,3.4,0.0,8.3,322205.28125,2541.42641242412
50030,11435,11435,36081027000,185068,0,Census Tract 270,New York,Queens County,822,1618,1076,851,0,778,44,29,225,225,0,225,0,0,542,497,0,464,33,45,74,4.6,3.4,0.0,8.3,322205.28125,2541.42641242412
50031,11373,11373,36081027100,138855,0,Census Tract 271,New York,Queens County,4038,6755,4406,4342,0,3766,272,304,64,64,0,64,0,0,2349,2048,0,1997,51,301,605,9.0,7.0,0.0,12.8,242156.02734375,2505.0632117342197
50032,11434,11434,36081027200,153675,0,Census Tract 272,New York,Queens County,1016,1730,1104,1016,0,793,223,0,88,83,0,83,0,5,626,566,14,358,194,60,65,3.8,0.0,5.7,9.6,267508.4609375,2442.2500963082102
50033,11372,11372,36081027300,215251,0,Census Tract 273,New York,Queens County,3228,5331,3691,3538,0,2993,235,310,153,139,0,139,0,14,1640,1422,0,1247,175,218,542,10.2,8.8,9.2,13.3,375467.296875,3040.32000414533
50034,11434,11434,36081027400,143723,0,Census Tract 274,New York,Queens County,771,1318,873,828,16,605,150,57,45,45,0,45,0,0,445,374,0,334,40,71,128,9.7,6.9,0.0,16.0,250197.48046875,2351.3432214998
50035,11372,11372,36081027500,177626,0,Census Tract 275,New York,Queens County,3054,5046,3401,3256,0,2784,270,202,145,145,0,121,24,0,1645,1399,0,1304,95,246,448,8.9,6.2,0.0,15.0,309834.68359375,2976.2382125416198
50036,11434,11434,36081027600,158733,0,Census Tract 276,New York,Queens County,724,1263,788,750,0,587,137,26,38,38,0,38,0,0,475,440,0,349,91,35,61,4.8,3.5,0.0,7.4,276344.96484375,2473.5231290055
50037,11372,11372,36081027700,174892,0,Census Tract 277,New York,Queens County,3836,6623,4555,4372,0,3530,306,536,183,120,0,120,0,63,2068,1931,0,1677,254,137,736,11.1,12.3,34.4,6.6,305071.26953125,2986.1273143435997
50038,11434,11434,36081027800,175380,0,Census Tract 278,New York,Queens County,871,1901,1005,924,0,676,195,53,81,71,0,44,27,10,896,792,6,589,197,104,167,8.8,5.7,12.3,11.6,305317.3046875,2311.58814889147
50039,11372,11372,36081027900,177155,0,Census Tract 279,New York,Queens County,3073,5518,3218,3131,0,2860,213,58,87,87,0,87,0,0,2300,1595,0,1273,322,705,763,13.8,1.9,0.0,30.7,309008.765625,2972.01028317373
50040,11434,11434,36081028000,165398,0,Census Tract 280,New York,Queens County,985,1446,1060,985,26,913,46,0,75,75,7,68,0,0,386,381,21,345,15,5,5,0.3,0.0,0.0,1.3,287959.37890625,2732.43530778949
50041,11372,11372,36081028100,174444,0,Census Tract 281,New York,Queens County,2825,4281,3013,2825,0,2585,240,0,188,169,0,169,0,19,1268,938,0,890,48,330,349,8.2,0.0,10.1,26.0,304285.15234375,2978.6621732536896
50042,11434,11434,36081028200,182472,0,Census Tract 282,New York,Queens County,978,1491,1025,990,0,822,156,12,35,35,0,35,0,0,466,449,0,377,72,17,29,1.9,1.2,0.0,3.6,317649.8203125,2832.66635432279
50043,11372,11372,36081028300,177715,0,Census Tract 283,New York,Queens County,4120,6504,4313,4138,46,3923,151,18,175,175,0,175,0,0,2191,2057,24,1872,161,134,152,2.3,0.4,0.0,6.1,309982.17578125,2977.2028867440304
50044,11434,11434,36081028400,429455,0,Census Tract 284,New York,Queens County,1929,3374,2176,1977,12,1531,386,48,199,199,0,167,32,0,1198,1008,8,749,251,190,238,7.1,2.4,0.0,15.9,747545.47265625,3591.9750756783396
50045,11372,11372,36081028500,158104,0,Census Tract 285,New York,Queens County,2188,3883,2515,2188,0,1905,283,0,327,222,0,167,55,105,1368,1045,0,806,239,323,428,11.0,0.0,32.1,23.6,275777.02734375,2977.5812328680604
50046,11372,11372,36081028700,195625,0,Census Tract 287,New York,Queens County,3437,5312,3619,3582,0,3160,277,145,37,37,0,20,17,0,1693,1527,0,1479,48,166,311,5.9,4.0,0.0,9.8,341219.40625,3200.70257059772
50047,11434,11434,36081028800,711115,106288,Census Tract 288,New York,Queens County,2420,3955,2768,2575,0,2244,176,155,193,193,0,172,21,0,1187,1039,0,872,167,148,303,7.7,6.0,0.0,12.5,1422690.9609375,5204.926221870301
50048,11372,11372,36081028900,172620,0,Census Tract 289,New York,Queens County,2642,4310,2840,2737,0,2347,295,95,103,103,0,103,0,0,1470,1358,0,1006,352,112,207,4.8,3.5,0.0,7.6,301095.39453125,2945.6959058746397
50049,11372,11372,36081029100,261476,0,Census Tract 291,New York,Queens County,2868,4997,3225,3005,0,2560,308,137,220,220,0,206,14,0,1772,1449,0,1346,103,323,460,9.2,4.6,0.0,18.2,456081.95703125,3024.8047265491805
50049,11377,11377,36081029100,261476,0,Census Tract 291,New York,Queens County,2868,4997,3225,3005,0,2560,308,137,220,220,0,206,14,0,1772,1449,0,1346,103,323,460,9.2,4.6,0.0,18.2,456081.95703125,3024.8047265491805
50050,11377,11377,36081029300,151334,0,Census Tract 293,New York,Queens County,564,964,608,596,0,554,10,32,12,12,0,8,4,0,356,317,0,313,4,39,71,7.4,5.4,0.0,11.0,263975.80859375,2473.7451580907896
50051,11434,11434,36081029400,1064506,0,Census Tract 294,New York,Queens County,3214,5062,3406,3349,13,2732,469,135,57,57,0,57,0,0,1656,1476,13,1321,142,180,315,6.2,4.0,0.0,10.9,1852362.94140625,6094.152501199921
50052,11377,11377,36081029500,182968,0,Census Tract 295,New York,Queens County,1936,3176,2055,2019,0,1869,67,83,36,36,0,36,0,0,1121,972,0,963,9,149,232,7.3,4.1,0.0,13.3,319189.9765625,2867.5661291452
50053,11103,11103,36081029700,519223,0,Census Tract 297,New York,Queens County,829,1523,891,843,0,769,60,14,48,48,0,34,14,0,632,552,0,530,22,80,94,6.2,1.7,0.0,12.7,905870.22265625,5168.6847257153795
50053,11377,11377,36081029700,519223,0,Census Tract 297,New York,Queens County,829,1523,891,843,0,769,60,14,48,48,0,34,14,0,632,552,0,530,22,80,94,6.2,1.7,0.0,12.7,905870.22265625,5168.6847257153795
50054,11377,11377,36081029900,408255,0,Census Tract 299,New York,Queens County,0,0,0,0,0,0,0,0,0,0,0,0,0,0,0,0,0,0,0,0,0,,,,,712374.90234375,3488.45769855878
50055,11434,11434,36081030600,1351074,0,Census Tract 306,New York,Queens County,2135,3575,2297,2177,0,1923,212,42,120,83,0,62,21,37,1278,1115,0,885,230,163,242,6.8,1.9,30.8,12.8,2350569.75390625,8914.48286394484
50056,11370,11370,36081030902,410707,0,Census Tract 309.02,New York,Queens County,3125,5568,3386,3228,0,2937,188,103,158,158,0,158,0,0,2182,1865,0,1748,117,317,420,7.5,3.2,0.0,14.5,716529.7734375,3616.9983161776795
50056,11377,11377,36081030902,410707,0,Census Tract 309.02,New York,Queens County,3125,5568,3386,3228,0,2937,188,103,158,158,0,158,0,0,2182,1865,0,1748,117,317,420,7.5,3.2,0.0,14.5,716529.7734375,3616.9983161776795
50057,11370,11370,36081030903,351702,0,Census Tract 309.03,New York,Queens County,2841,4910,3014,2893,24,2661,156,52,121,121,0,121,0,0,1896,1751,45,1614,92,145,197,4.0,1.8,0.0,7.6,613583.96875,3140.29701316287
50058,11370,11370,36081030904,414419,0,Census Tract 309.04,New York,Queens County,1691,2916,1840,1708,0,1646,45,17,132,132,0,115,17,0,1076,916,0,764,152,160,177,6.1,1.0,0.0,14.9,723117.33203125,3882.8209445970397
50059,11105,11105,36081031700,767638,0,Census Tract 317,New York,Queens County,2858,5162,2993,2896,0,2728,130,38,97,97,0,97,0,0,2169,1929,0,1736,193,240,278,5.4,1.3,0.0,11.1,1198673.6171875,5890.59446799527
50059,11370,11370,36081031700,767638,0,Census Tract 317,New York,Queens County,2858,5162,2993,2896,0,2728,130,38,97,97,0,97,0,0,2169,1929,0,1736,193,240,278,5.4,1.3,0.0,11.1,1198673.6171875,5890.59446799527
50060,11413,11413,36081032000,1040173,13031,Census Tract 320,New York,Queens County,1744,2777,2050,1869,0,1506,238,125,181,171,0,171,0,10,727,630,0,571,59,97,232,8.4,6.7,5.5,13.3,1832151.94140625,5909.62693801041
50060,11434,11434,36081032000,1040173,13031,Census Tract 320,New York,Queens County,1744,2777,2050,1869,0,1506,238,125,181,171,0,171,0,10,727,630,0,571,59,97,232,8.4,6.7,5.5,13.3,1832151.94140625,5909.62693801041
50061,11370,11370,36081032700,150852,0,Census Tract 327,New York,Queens County,1772,2958,1927,1772,68,1549,155,0,155,155,0,136,19,0,1031,899,0,871,28,132,132,4.5,0.0,0.0,12.8,263181.84765625,2306.3072288177696
50062,11413,11413,36081032800,368019,0,Census Tract 328,New York,Queens County,1289,2131,1416,1324,0,1259,30,35,92,92,0,92,0,0,715,671,0,646,25,44,79,3.7,2.6,0.0,6.2,640400.39453125,4454.67892051512
50063,11369,11369,36081032900,436914,0,Census Tract 329,New York,Queens County,1628,2784,1736,1661,7,1187,434,33,75,75,7,68,0,0,1048,983,0,822,161,65,98,3.5,2.0,0.0,6.2,762397.7890625,3676.02069411536
50063,11370,11370,36081032900,436914,0,Census Tract 329,New York,Queens County,1628,2784,1736,1661,7,1187,434,33,75,75,7,68,0,0,1048,983,0,822,161,65,98,3.5,2.0,0.0,6.2,762397.7890625,3676.02069411536
50064,11413,11413,36081033000,817317,0,Census Tract 330,New York,Queens County,3532,5693,3789,3532,0,3259,273,0,257,239,0,210,29,18,1904,1751,0,1558,193,153,171,3.0,0.0,7.0,8.0,1422178.61328125,6066.257963324721
50064,11434,11434,36081033000,817317,0,Census Tract 330,New York,Queens County,3532,5693,3789,3532,0,3259,273,0,257,239,0,210,29,18,1904,1751,0,1558,193,153,171,3.0,0.0,7.0,8.0,1422178.61328125,6066.257963324721
50065,11371,11369,36081033100,2837110,2193944,Census Tract 331,New York,Queens County,0,0,0,0,0,0,0,0,0,0,0,0,0,0,0,0,0,0,0,0,0,,,,,4438567.96875,11445.385999734099
50066,11434,11434,36081033401,560661,0,Census Tract 334.01,New York,Queens County,1637,2701,1810,1694,0,1273,364,57,116,116,0,116,0,0,891,805,0,575,230,86,143,5.3,3.4,0.0,9.7,975841.6171875,4317.42941896378
50067,11434,11434,36081033402,757757,0,Census Tract 334.02,New York,Queens County,5957,11324,6516,6194,0,5414,543,237,322,322,0,300,22,0,4808,3819,0,3202,617,989,1226,10.8,3.8,0.0,20.6,1318735.8359375,4999.803636800621
50068,11369,11369,36081033700,150835,0,Census Tract 337,New York,Queens County,1516,2563,1701,1615,0,1458,58,99,86,86,0,86,0,0,862,829,0,789,40,33,132,5.2,6.1,0.0,3.8,263155.94921875,2305.23981317927
50068,11370,11370,36081033700,150835,0,Census Tract 337,New York,Queens County,1516,2563,1701,1615,0,1458,58,99,86,86,0,86,0,0,862,829,0,789,40,33,132,5.2,6.1,0.0,3.8,263155.94921875,2305.23981317927
50069,11369,11369,36081033900,150839,0,Census Tract 339,New York,Queens County,1249,2154,1282,1249,0,1147,102,0,33,33,0,33,0,0,872,793,0,758,35,79,79,3.7,0.0,0.0,9.1,263164.703125,2303.62475520543
50069,11372,11372,36081033900,150839,0,Census Tract 339,New York,Queens County,1249,2154,1282,1249,0,1147,102,0,33,33,0,33,0,0,872,793,0,758,35,79,79,3.7,0.0,0.0,9.1,263164.703125,2303.62475520543
50070,11369,11369,36081034700,382772,0,Census Tract 347,New York,Queens County,1366,2424,1522,1419,0,1288,78,53,103,97,0,74,23,6,902,713,0,659,54,189,248,10.2,3.7,5.8,21.0,667970.19140625,5404.86899169068
50071,11369,11369,36081035100,139241,0,Census Tract 351,New York,Queens County,1676,3430,1956,1735,0,1612,64,59,221,221,0,221,0,0,1474,1088,18,1029,41,386,445,13.0,3.4,0.0,26.2,242931.11328125,2201.4614945324697
50072,11413,11413,36081035200,606225,0,Census Tract 352,New York,Queens County,1338,2185,1470,1386,0,1117,221,48,84,84,0,84,0,0,715,669,27,589,53,46,94,4.3,3.5,0.0,6.4,1055157.53125,5202.340274638621
50072,11434,11434,36081035200,606225,0,Census Tract 352,New York,Queens County,1338,2185,1470,1386,0,1117,221,48,84,84,0,84,0,0,715,669,27,589,53,46,94,4.3,3.5,0.0,6.4,1055157.53125,5202.340274638621
50073,11369,11369,36081035300,155113,0,Census Tract 353,New York,Queens County,1160,2138,1256,1190,0,1111,49,30,66,66,0,62,4,0,882,694,0,646,48,188,218,10.2,2.5,0.0,21.3,270623.94140625,2499.69825433794
50074,11369,11369,36081035700,618526,0,Census Tract 357,New York,Queens County,1569,2756,1682,1610,0,1472,97,41,72,72,0,72,0,0,1074,827,0,809,18,247,288,10.4,2.5,0.0,23.0,1079413.1171875,4464.41585828115
50075,11413,11413,36081035800,524485,0,Census Tract 358,New York,Queens County,1995,3389,2256,2092,0,1734,261,97,164,164,0,138,26,0,1133,973,23,830,120,160,257,7.6,4.6,0.0,14.1,912789.11328125,3985.1991843098
50076,11369,11369,36081036100,157372,0,Census Tract 361,New York,Queens County,1108,1988,1276,1165,0,967,141,57,111,92,0,81,11,19,712,611,0,529,82,101,177,8.9,4.9,17.1,14.2,274582.24609375,3001.38223822812
50077,11369,11369,36081036300,134898,0,Census Tract 363,New York,Queens County,727,1297,792,732,0,685,42,5,60,60,0,54,6,0,505,486,0,420,66,19,24,1.9,0.7,0.0,3.8,235356.2890625,2104.1736678375
50078,11369,11369,36081036500,166196,0,Census Tract 365,New York,Queens County,1384,2290,1558,1450,0,1238,146,66,108,104,0,76,28,4,732,618,0,510,108,114,184,8.0,4.6,3.7,15.6,289963.5078125,2200.63436732053
50079,11412,11412,36081036600,369653,0,Census Tract 366,New York,Queens County,1367,2344,1502,1388,35,1249,83,21,114,114,0,114,0,0,842,675,3,605,67,167,188,8.0,1.5,0.0,19.8,643512.8828125,4519.53751152135
50079,11413,11413,36081036600,369653,0,Census Tract 366,New York,Queens County,1367,2344,1502,1388,35,1249,83,21,114,114,0,114,0,0,842,675,3,605,67,167,188,8.0,1.5,0.0,19.8,643512.8828125,4519.53751152135
50079,11434,11434,36081036600,369653,0,Census Tract 366,New York,Queens County,1367,2344,1502,1388,35,1249,83,21,114,114,0,114,0,0,842,675,3,605,67,167,188,8.0,1.5,0.0,19.8,643512.8828125,4519.53751152135
50080,11369,11369,36081036700,195576,0,Census Tract 367,New York,Queens County,999,1939,1190,1058,0,964,35,59,132,132,0,132,0,0,749,624,0,593,31,125,184,9.5,5.6,0.0,16.7,341259.71484375,2520.92529918558
50081,11434,11434,36081036800,232844,0,Census Tract 368,New York,Queens County,1142,2085,1328,1181,0,1010,132,39,147,147,0,112,35,0,757,695,0,582,113,62,101,4.8,3.3,0.0,8.2,405342.6171875,2584.55792709941
50082,11369,11369,36081037100,187474,0,Census Tract 371,New York,Queens County,613,1102,651,617,0,586,27,4,34,34,0,34,0,0,451,366,0,366,0,85,89,8.1,0.6,0.0,18.8,327128.02734375,2763.39057504704
50083,11368,11368,36081037300,238080,0,Census Tract 373,New York,Queens County,871,1534,978,939,0,768,103,68,39,39,0,39,0,0,556,482,0,434,48,74,142,9.3,7.2,0.0,13.3,415373.4609375,3017.09566242339
50083,11369,11369,36081037300,238080,0,Census Tract 373,New York,Queens County,871,1534,978,939,0,768,103,68,39,39,0,39,0,0,556,482,0,434,48,74,142,9.3,7.2,0.0,13.3,415373.4609375,3017.09566242339
50084,11368,11368,36081037500,153192,0,Census Tract 375,New York,Queens County,1901,3130,2199,2135,0,1770,131,234,64,55,0,55,0,9,931,695,0,584,111,236,479,15.3,11.0,14.1,25.3,267207.83203125,4187.14597460514
50084,11372,11372,36081037500,153192,0,Census Tract 375,New York,Queens County,1901,3130,2199,2135,0,1770,131,234,64,55,0,55,0,9,931,695,0,584,111,236,479,15.3,11.0,14.1,25.3,267207.83203125,4187.14597460514
50085,11412,11412,36081037600,769753,0,Census Tract 376,New York,Queens County,3015,4952,3326,3084,18,2585,412,69,242,233,0,170,63,9,1626,1413,0,1152,261,213,291,5.9,2.2,3.7,13.1,1340116.59375,6760.8368934888795
50085,11413,11413,36081037600,769753,0,Census Tract 376,New York,Queens County,3015,4952,3326,3084,18,2585,412,69,242,233,0,170,63,9,1626,1413,0,1152,261,213,291,5.9,2.2,3.7,13.1,1340116.59375,6760.8368934888795
50086,11368,11368,36081037700,146818,0,Census Tract 377,New York,Queens County,1787,2635,1997,1897,0,1584,203,110,100,53,0,37,16,47,638,551,0,428,123,87,244,9.3,5.8,47.0,13.6,256123.88671875,2032.0262836759803
50087,11368,11368,36081037900,197067,0,Census Tract 379,New York,Queens County,3583,5087,3873,3721,0,3010,573,138,152,141,0,117,24,11,1214,1031,0,708,323,183,332,6.5,3.7,7.2,15.1,343779.8125,2473.59445942628
50088,11368,11368,36081038100,284505,0,Census Tract 381,New York,Queens County,2908,5126,3340,3140,0,2329,579,232,200,182,0,163,19,18,1786,1559,0,1315,244,227,477,9.3,7.4,9.0,12.7,496325.69921875,2825.87460893253
50089,11368,11368,36081038301,560162,150182,Census Tract 383.01,New York,Queens County,0,0,0,0,0,0,0,0,0,0,0,0,0,0,0,0,0,0,0,0,0,,,,,928464.65234375,3999.00663684892
50090,11367,11367,36081038302,4482808,1281692,Census Tract 383.02,New York,Queens County,0,0,0,0,0,0,0,0,0,0,0,0,0,0,0,0,0,0,0,0,0,,,,,8784489.15234375,23635.4439917177
50090,11368,11368,36081038302,4482808,1281692,Census Tract 383.02,New York,Queens County,0,0,0,0,0,0,0,0,0,0,0,0,0,0,0,0,0,0,0,0,0,,,,,8784489.15234375,23635.4439917177
50090,11375,11375,36081038302,4482808,1281692,Census Tract 383.02,New York,Queens County,0,0,0,0,0,0,0,0,0,0,0,0,0,0,0,0,0,0,0,0,0,,,,,8784489.15234375,23635.4439917177
50091,11411,11411,36081038400,297515,0,Census Tract 384,New York,Queens County,929,1850,1242,1092,31,894,4,163,150,81,0,81,0,69,608,494,0,489,5,114,346,18.7,14.9,46.0,18.8,518050.84765625,3129.40934178084
50091,11412,11412,36081038400,297515,0,Census Tract 384,New York,Queens County,929,1850,1242,1092,31,894,4,163,150,81,0,81,0,69,608,494,0,489,5,114,346,18.7,14.9,46.0,18.8,518050.84765625,3129.40934178084
50092,11412,11412,36081039400,348243,0,Census Tract 394,New York,Queens County,1505,2538,1713,1534,0,1369,136,29,179,162,0,131,31,17,825,765,0,656,109,60,106,4.2,1.9,9.5,7.3,606308.3359375,4368.080098617021
50093,11412,11412,36081039800,200591,0,Census Tract 398,New York,Queens County,968,1459,1072,991,0,905,63,23,81,81,0,81,0,0,387,369,0,317,52,18,41,2.8,2.3,0.0,4.7,349291.9609375,2693.7298142866002
50094,11368,11368,36081039900,169666,0,Census Tract 399,New York,Queens County,1707,2897,1923,1877,0,1209,498,170,46,46,0,46,0,0,974,796,0,694,102,178,348,12.0,9.1,0.0,18.3,295947.36328125,2518.1119235521
50095,11412,11412,36081040000,196301,0,Census Tract 400,New York,Queens County,820,1264,891,851,0,806,14,31,40,34,0,34,0,6,373,336,5,313,18,37,74,5.9,3.6,15.0,9.9,341858.2265625,2525.2937898676396
50096,11368,11368,36081040100,211990,0,Census Tract 401,New York,Queens County,3200,5412,4070,3852,0,2738,462,652,218,146,0,134,12,72,1342,1078,0,864,214,264,988,18.3,16.9,33.0,19.7,369768.7890625,2793.3955425278496
50097,11412,11412,36081040200,218312,0,Census Tract 402,New York,Queens County,873,1353,942,873,0,859,14,0,69,69,0,69,0,0,411,394,0,394,0,17,17,1.3,0.0,0.0,4.1,380215.55859375,2700.53688428085
50098,11368,11368,36081040300,199944,0,Census Tract 403,New York,Queens County,3238,5182,3615,3341,47,2789,402,103,274,274,0,246,28,0,1567,1414,0,1285,129,153,256,4.9,3.1,0.0,9.8,348748.7890625,2675.9079702595
50099,11412,11412,36081040400,479414,0,Census Tract 404,New York,Queens County,1824,3254,2132,1880,0,1798,26,56,252,214,0,155,59,38,1122,1016,0,968,48,106,200,6.1,3.0,15.1,9.4,835075.54296875,3870.5853481007002
50099,11423,11423,36081040400,479414,0,Census Tract 404,New York,Queens County,1824,3254,2132,1880,0,1798,26,56,252,214,0,155,59,38,1122,1016,0,968,48,106,200,6.1,3.0,15.1,9.4,835075.54296875,3870.5853481007002
50100,11368,11368,36081040500,129469,0,Census Tract 405,New York,Queens County,1395,2459,1801,1692,0,1134,261,297,109,109,0,93,16,0,658,533,0,469,64,125,422,17.2,17.6,0.0,19.0,225822.375,2784.79866571247
50101,11368,11368,36081040700,199521,0,Census Tract 407,New York,Queens County,4184,6670,4652,4467,0,3046,1138,283,185,168,0,117,51,17,2018,1616,0,1307,309,402,702,10.5,6.3,9.2,19.9,348006.4609375,3522.4279140179206
50102,11368,11368,36081040900,152469,0,Census Tract 409,New York,Queens County,2354,4273,2786,2676,0,1765,589,322,110,60,0,50,10,50,1487,1126,0,1004,122,361,733,17.2,12.0,45.5,24.3,265930.9140625,3222.23537004313
50103,11368,11368,36081041100,137681,0,Census Tract 411,New York,Queens County,1976,3128,2122,2028,15,1734,227,52,94,94,0,94,0,0,1006,906,16,835,55,100,152,4.9,2.6,0.0,9.9,240101.87890625,2117.304830218
50104,11368,11368,36081041300,158802,0,Census Tract 413,New York,Queens County,2062,3373,2273,2211,0,1545,517,149,62,62,0,62,0,0,1100,951,0,728,223,149,298,8.8,6.7,0.0,13.5,276940.48046875,2256.2091795305
50105,11433,11433,36081041400,473215,0,Census Tract 414,New York,Queens County,2220,3653,2523,2220,0,2031,189,0,303,303,0,253,50,0,1130,867,0,771,96,263,263,7.2,0.0,0.0,23.3,824147.06640625,4039.0482299248297
50106,11368,11368,36081041500,170942,0,Census Tract 415,New York,Queens County,1897,3129,1999,1946,0,1728,169,49,53,53,0,43,10,0,1130,995,0,774,221,135,184,5.9,2.5,0.0,11.9,298124.1875,2255.18731483738
50107,11412,11412,36081042400,516440,0,Census Tract 424,New York,Queens County,1244,2050,1362,1244,11,1083,150,0,118,118,0,118,0,0,688,645,0,580,65,43,43,2.1,0.0,0.0,6.3,899307.1171875,4327.699626569671
50107,11433,11433,36081042400,516440,0,Census Tract 424,New York,Queens County,1244,2050,1362,1244,11,1083,150,0,118,118,0,118,0,0,688,645,0,580,65,43,43,2.1,0.0,0.0,6.3,899307.1171875,4327.699626569671
50107,11434,11434,36081042400,516440,0,Census Tract 424,New York,Queens County,1244,2050,1362,1244,11,1083,150,0,118,118,0,118,0,0,688,645,0,580,65,43,43,2.1,0.0,0.0,6.3,899307.1171875,4327.699626569671
50108,11434,11434,36081042600,521709,0,Census Tract 426,New York,Queens County,0,0,0,0,0,0,0,0,0,0,0,0,0,0,0,0,0,0,0,0,0,,,,,908308.921875,4020.46792095349
50109,11368,11368,36081042700,170556,0,Census Tract 427,New York,Queens County,2537,3682,2618,2589,0,2272,265,52,29,29,0,23,6,0,1064,936,0,827,109,128,180,4.9,2.0,0.0,12.0,297425.7578125,2741.59008803715
50110,11434,11434,36081043200,238369,0,Census Tract 432,New York,Queens County,616,1069,712,631,3,574,39,15,81,81,0,68,13,0,357,350,0,281,69,7,22,2.1,2.4,0.0,2.0,415037.453125,3745.28673158115
50111,11433,11433,36081043400,205351,0,Census Tract 434,New York,Queens County,931,1437,1017,938,0,931,0,7,79,79,0,79,0,0,420,399,4,333,62,21,28,1.9,0.7,0.0,5.0,357599.32421875,2907.4139968109603
50112,11368,11368,36081043701,145211,0,Census Tract 437.01,New York,Queens County,1242,1943,1334,1280,0,1145,97,38,54,54,0,34,20,0,609,558,0,496,62,51,89,4.6,3.0,0.0,8.4,253193.1328125,2216.72263816677
50112,11375,11375,36081043701,145211,0,Census Tract 437.01,New York,Queens County,1242,1943,1334,1280,0,1145,97,38,54,54,0,34,20,0,609,558,0,496,62,51,89,4.6,3.0,0.0,8.4,253193.1328125,2216.72263816677
50113,11368,11368,36081043702,175706,0,Census Tract 437.02,New York,Queens County,3018,5016,3274,3101,0,2655,363,83,173,173,0,65,108,0,1742,1540,0,1373,167,202,285,5.7,2.7,0.0,11.6,306357.5625,2280.6373732016
50114,11368,11368,36081043900,164750,0,Census Tract 439,New York,Queens County,1597,2869,1980,1790,0,1305,292,193,190,174,0,174,0,16,889,721,0,664,57,168,377,13.1,10.8,8.4,18.9,287287.71875,2374.96070150608
50115,11433,11433,36081044000,378559,0,Census Tract 440,New York,Queens County,1588,3002,1975,1664,11,1486,91,76,311,296,0,276,20,15,1027,917,10,796,111,110,201,6.7,4.6,4.8,10.7,659354.91015625,3632.7913330035103
50116,11368,11368,36081044301,133649,0,Census Tract 443.01,New York,Queens County,1209,2970,1530,1292,0,992,217,83,238,220,0,192,28,18,1440,1028,0,753,275,412,513,17.3,6.4,7.6,28.6,233047.57421875,2334.78435284996
50117,11368,11368,36081044302,277955,0,Census Tract 443.02,New York,Queens County,1792,3447,2155,2030,0,1693,99,238,125,125,0,125,0,0,1292,1024,0,944,80,268,506,14.7,11.7,0.0,20.7,484664.25390625,2771.6500560076397
50117,11373,11373,36081044302,277955,0,Census Tract 443.02,New York,Queens County,1792,3447,2155,2030,0,1693,99,238,125,125,0,125,0,0,1292,1024,0,944,80,268,506,14.7,11.7,0.0,20.7,484664.25390625,2771.6500560076397
50118,11412,11412,36081044400,897131,0,Census Tract 444,New York,Queens County,1388,2562,1601,1476,0,1257,131,88,125,107,0,107,0,18,961,825,5,776,44,136,242,9.4,6.0,14.4,14.2,1562714.4453125,8315.56590592264
50118,11423,11423,36081044400,897131,0,Census Tract 444,New York,Queens County,1388,2562,1601,1476,0,1257,131,88,125,107,0,107,0,18,961,825,5,776,44,136,242,9.4,6.0,14.4,14.2,1562714.4453125,8315.56590592264
50118,11432,11432,36081044400,897131,0,Census Tract 444,New York,Queens County,1388,2562,1601,1476,0,1257,131,88,125,107,0,107,0,18,961,825,5,776,44,136,242,9.4,6.0,14.4,14.2,1562714.4453125,8315.56590592264
50118,11433,11433,36081044400,897131,0,Census Tract 444,New York,Queens County,1388,2562,1601,1476,0,1257,131,88,125,107,0,107,0,18,961,825,5,776,44,136,242,9.4,6.0,14.4,14.2,1562714.4453125,8315.56590592264
50119,11432,11432,36081044601,224773,0,Census Tract 446.01,New York,Queens County,1459,2497,1707,1606,0,1429,30,147,101,70,0,60,10,31,790,489,0,454,35,301,479,19.2,9.2,30.7,38.1,391522.15234375,2515.81276623004
50119,11433,11433,36081044601,224773,0,Census Tract 446.01,New York,Queens County,1459,2497,1707,1606,0,1429,30,147,101,70,0,60,10,31,790,489,0,454,35,301,479,19.2,9.2,30.7,38.1,391522.15234375,2515.81276623004
50120,11432,11432,36081044602,170076,0,Census Tract 446.02,New York,Queens County,1639,3017,1873,1750,0,1489,150,111,123,110,0,88,22,13,1144,921,0,821,100,223,347,11.5,6.3,10.6,19.5,296277.46875,2225.3715849303303
50121,11432,11432,36081044800,208002,0,Census Tract 448,New York,Queens County,1146,2056,1311,1192,0,1050,96,46,119,119,0,119,0,0,745,726,0,622,104,19,65,3.2,3.9,0.0,2.6,362372.90625,2820.72672463492
50122,11432,11432,36081045000,172164,0,Census Tract 450,New York,Queens County,1114,1826,1208,1114,0,1067,47,0,94,92,0,84,8,2,618,579,0,543,36,39,41,2.2,0.0,2.1,6.3,299967.94140625,2253.11768171867
50123,11432,11432,36081045200,214219,0,Census Tract 452,New York,Queens County,341,660,372,355,0,337,4,14,17,17,0,17,0,0,288,265,0,255,10,23,37,5.6,3.9,0.0,8.0,373248.9296875,2888.71126552308
50124,11432,11432,36081045400,230996,0,Census Tract 454,New York,Queens County,1879,3469,2093,1956,11,1711,157,77,137,137,0,128,9,0,1376,1264,0,1202,62,112,189,5.4,3.9,0.0,8.1,402452.8515625,3370.0639548970803
50125,11368,11368,36081045500,148244,0,Census Tract 455,New York,Queens County,7253,11682,7684,7408,0,6419,834,155,276,276,0,276,0,0,3998,3418,0,2505,913,580,735,6.3,2.1,0.0,14.5,258462.39453125,2131.05031999425
50126,11432,11432,36081045600,162232,0,Census Tract 456,New York,Queens County,578,1112,629,578,23,545,10,0,51,51,0,51,0,0,483,458,29,411,18,25,25,2.2,0.0,0.0,5.2,282683.9140625,3064.3643043827697
50127,11373,11373,36081045700,150517,0,Census Tract 457,New York,Queens County,1673,2566,1904,1856,0,1574,99,183,48,48,0,48,0,0,662,548,0,502,46,114,297,11.6,9.9,0.0,17.2,262435.6640625,2243.82472661648
50128,11432,11432,36081045800,245281,0,Census Tract 458,New York,Queens County,1054,1788,1160,1071,0,1005,49,17,89,89,0,89,0,0,628,576,0,533,43,52,69,3.9,1.6,0.0,8.3,427373.125,3599.0474435956
50129,11373,11373,36081045900,136886,0,Census Tract 459,New York,Queens County,1696,2703,1843,1716,0,1682,14,20,127,127,0,127,0,0,860,802,0,798,4,58,78,2.9,1.2,0.0,6.7,238684.7578125,2177.54787163833
50130,11432,11432,36081046000,221268,0,Census Tract 460,New York,Queens County,2384,4611,2996,2800,22,2183,179,416,196,175,0,149,26,21,1615,1288,0,1188,100,327,764,16.6,14.9,10.7,20.2,385457.50390625,2519.17912582592
50131,11373,11373,36081046100,112817,0,Census Tract 461,New York,Queens County,1155,2004,1317,1205,0,1128,27,50,112,101,0,101,0,11,687,626,0,616,10,61,122,6.1,4.1,9.8,8.9,196723.91015625,2161.06165763912
50132,11432,11432,36081046200,249611,0,Census Tract 462,New York,Queens County,3082,5291,3402,3249,0,2680,402,167,153,153,0,139,14,0,1889,1634,17,1412,205,255,422,8.0,5.1,0.0,13.5,434851.1015625,2792.3065759652195
50133,11373,11373,36081046300,159415,0,Census Tract 463,New York,Queens County,1921,3170,2201,2127,0,1750,171,206,74,60,0,54,6,14,969,879,0,847,32,90,310,9.8,9.7,18.9,9.3,278001.7578125,2650.90248609917
50134,11432,11432,36081046400,228767,0,Census Tract 464,New York,Queens County,739,1142,796,739,0,739,0,0,57,57,0,57,0,0,346,305,0,305,0,41,41,3.6,0.0,0.0,11.8,398624.60546875,3888.38014587257
50135,11368,11368,36081046500,129758,0,Census Tract 465,New York,Queens County,1748,2871,1975,1898,0,1433,315,150,77,67,0,67,0,10,896,788,0,671,117,108,268,9.3,7.9,13.0,12.1,226303.9609375,1979.3783011091398
50135,11373,11373,36081046500,129758,0,Census Tract 465,New York,Queens County,1748,2871,1975,1898,0,1433,315,150,77,67,0,67,0,10,896,788,0,671,117,108,268,9.3,7.9,13.0,12.1,226303.9609375,1979.3783011091398
50136,11432,11432,36081046600,240535,0,Census Tract 466,New York,Queens County,1628,2791,1811,1660,0,1518,110,32,151,151,0,151,0,0,980,868,0,855,13,112,144,5.2,1.9,0.0,11.4,419091.15625,3178.65126072175
50137,11373,11373,36081046700,141858,0,Census Tract 467,New York,Queens County,2630,4696,2938,2758,0,2321,309,128,180,180,0,180,0,0,1758,1238,0,957,281,520,648,13.8,4.6,0.0,29.6,247395.69140625,2596.78256323803
50138,11423,11423,36081046800,229419,0,Census Tract 468,New York,Queens County,1363,2667,1540,1440,20,1300,43,77,100,98,0,76,22,2,1127,1008,18,909,81,119,198,7.4,5.3,2.0,10.6,399678.328125,2617.3550018106603
50138,11432,11432,36081046800,229419,0,Census Tract 468,New York,Queens County,1363,2667,1540,1440,20,1300,43,77,100,98,0,76,22,2,1127,1008,18,909,81,119,198,7.4,5.3,2.0,10.6,399678.328125,2617.3550018106603
50139,11373,11373,36081046900,151385,0,Census Tract 469,New York,Queens County,3738,6212,3961,3804,19,3281,438,66,157,157,0,157,0,0,2251,1897,37,1560,300,354,420,6.8,1.7,0.0,15.7,264007.171875,2927.05777210792
50140,11423,11423,36081047000,229319,0,Census Tract 470,New York,Queens County,1471,2717,1635,1493,19,1337,115,22,142,142,0,142,0,0,1082,1026,18,928,80,56,78,2.9,1.5,0.0,5.2,399519.28515625,2668.29477903694
50141,11373,11373,36081047100,158097,0,Census Tract 471,New York,Queens County,1946,3381,2110,1990,0,1863,83,44,120,120,0,120,0,0,1271,1179,10,1118,51,92,136,4.0,2.2,0.0,7.2,275677.3359375,2331.52490783527
50142,11423,11423,36081047200,520868,0,Census Tract 472,New York,Queens County,1728,2832,1840,1757,7,1687,34,29,83,83,0,83,0,0,992,878,0,861,17,114,143,5.0,1.7,0.0,11.5,907621.58203125,4190.97228350893
50142,11432,11432,36081047200,520868,0,Census Tract 472,New York,Queens County,1728,2832,1840,1757,7,1687,34,29,83,83,0,83,0,0,992,878,0,861,17,114,143,5.0,1.7,0.0,11.5,907621.58203125,4190.97228350893
50143,11373,11373,36081047300,198491,0,Census Tract 473,New York,Queens County,2230,3847,2438,2289,0,2080,150,59,149,149,0,135,14,0,1409,1249,0,1128,121,160,219,5.7,2.6,0.0,11.4,346075.828125,2907.07457752814
50144,11373,11373,36081047500,281982,0,Census Tract 475,New York,Queens County,2340,3365,2511,2340,7,2137,196,0,171,171,0,149,22,0,854,773,0,726,47,81,81,2.4,0.0,0.0,9.5,491587.56640625,3586.7624273334495
50145,11423,11423,36081047600,547425,0,Census Tract 476,New York,Queens County,785,1237,833,785,0,759,26,0,48,48,0,48,0,0,404,395,0,395,0,9,9,0.7,0.0,0.0,2.2,954036.67578125,4622.26450483127
50146,11423,11423,36081047800,653125,0,Census Tract 478,New York,Queens County,3027,4764,3352,3085,0,2611,416,58,267,267,0,267,0,0,1412,1240,0,1041,199,172,230,4.8,1.9,0.0,12.2,1138148.13671875,5884.38640255911
50146,11427,11427,36081047800,653125,0,Census Tract 478,New York,Queens County,3027,4764,3352,3085,0,2611,416,58,267,267,0,267,0,0,1412,1240,0,1041,199,172,230,4.8,1.9,0.0,12.2,1138148.13671875,5884.38640255911
50147,11373,11373,36081047900,392476,0,Census Tract 479,New York,Queens County,2462,4235,2571,2462,0,2391,71,0,109,109,0,109,0,0,1664,1538,9,1382,147,126,126,3.0,0.0,0.0,7.6,684265.953125,4711.09135338235
50148,11423,11423,36081048000,230261,0,Census Tract 480,New York,Queens County,1092,2169,1308,1132,21,1003,68,40,176,176,8,137,31,0,861,799,0,733,66,62,102,4.7,3.5,0.0,7.2,401178.9609375,2617.1133313714004
50149,11373,11373,36081048100,139052,0,Census Tract 481,New York,Queens County,2691,5072,2829,2720,0,2571,120,29,109,109,0,109,0,0,2243,1580,0,1542,38,663,692,13.6,1.1,0.0,29.6,242478.04296875,2250.14230900558
50150,11423,11423,36081048200,228378,0,Census Tract 482,New York,Queens County,689,1264,766,703,0,640,49,14,63,58,0,58,0,5,498,474,0,434,40,24,43,3.4,2.0,7.9,4.8,397917.5859375,2632.46436541702
50151,11373,11373,36081048300,221536,0,Census Tract 483,New York,Queens County,1865,3196,2086,2006,0,1797,68,141,80,80,0,80,0,0,1110,946,0,896,50,164,305,9.5,7.0,0.0,14.8,386307.0078125,3223.47950649115
50151,11377,11377,36081048300,221536,0,Census Tract 483,New York,Queens County,1865,3196,2086,2006,0,1797,68,141,80,80,0,80,0,0,1110,946,0,896,50,164,305,9.5,7.0,0.0,14.8,386307.0078125,3223.47950649115
50152,11423,11423,36081048400,414677,0,Census Tract 484,New York,Queens County,2951,4349,3280,3050,0,2865,86,99,230,230,0,230,0,0,1069,1008,0,966,42,61,160,3.7,3.2,0.0,5.7,722540.8671875,3523.3457439923704
50152,11427,11427,36081048400,414677,0,Census Tract 484,New York,Queens County,2951,4349,3280,3050,0,2865,86,99,230,230,0,230,0,0,1069,1008,0,966,42,61,160,3.7,3.2,0.0,5.7,722540.8671875,3523.3457439923704
50152,11428,11428,36081048400,414677,0,Census Tract 484,New York,Queens County,2951,4349,3280,3050,0,2865,86,99,230,230,0,230,0,0,1069,1008,0,966,42,61,160,3.7,3.2,0.0,5.7,722540.8671875,3523.3457439923704
50153,11373,11373,36081048500,317281,0,Census Tract 485,New York,Queens County,2469,3732,2595,2547,0,2457,12,78,48,48,0,48,0,0,1137,977,0,977,0,160,238,6.4,3.1,0.0,14.1,553235.0546875,4416.896020661649
50153,11377,11377,36081048500,317281,0,Census Tract 485,New York,Queens County,2469,3732,2595,2547,0,2457,12,78,48,48,0,48,0,0,1137,977,0,977,0,160,238,6.4,3.1,0.0,14.1,553235.0546875,4416.896020661649
50154,11373,11373,36081048900,362006,0,Census Tract 489,New York,Queens County,638,1126,682,659,0,601,37,21,23,23,0,23,0,0,444,398,0,366,32,46,67,6.0,3.2,0.0,10.4,631166.8984375,3826.2519515718395
50154,11377,11377,36081048900,362006,0,Census Tract 489,New York,Queens County,638,1126,682,659,0,601,37,21,23,23,0,23,0,0,444,398,0,366,32,46,67,6.0,3.2,0.0,10.4,631166.8984375,3826.2519515718395
50155,11427,11427,36081049200,486220,0,Census Tract 492,New York,Queens County,2563,4307,2798,2638,0,2492,71,75,160,160,0,160,0,0,1509,1301,0,1260,41,208,283,6.6,2.8,0.0,13.8,847380.30078125,4421.69844410581
50156,11377,11377,36081049301,164136,0,Census Tract 493.01,New York,Queens County,945,1692,1034,962,0,924,21,17,72,72,0,72,0,0,658,604,0,579,25,54,71,4.2,1.8,0.0,8.2,286136.02734375,2547.81403106059
50156,11378,11378,36081049301,164136,0,Census Tract 493.01,New York,Queens County,945,1692,1034,962,0,924,21,17,72,72,0,72,0,0,658,604,0,579,25,54,71,4.2,1.8,0.0,8.2,286136.02734375,2547.81403106059
50157,11378,11378,36081049302,275109,0,Census Tract 493.02,New York,Queens County,1336,2130,1433,1372,0,1294,42,36,61,61,0,61,0,0,697,605,0,557,48,92,128,6.0,2.6,0.0,13.2,479528.82421875,3644.73426735855
50158,11378,11378,36081049500,123282,0,Census Tract 495,New York,Queens County,622,1209,733,663,0,600,22,41,70,50,0,50,0,20,476,429,4,391,34,47,108,8.9,6.2,28.6,9.9,214870.4140625,2748.69247712561
50159,11428,11428,36081049600,273116,0,Census Tract 496,New York,Queens County,1419,2699,1651,1543,18,1365,36,124,108,95,0,78,17,13,1048,952,8,917,27,96,233,8.6,8.0,12.0,9.2,475903.671875,2734.02498143647
50160,11378,11378,36081049700,197571,0,Census Tract 497,New York,Queens County,1537,2491,1629,1565,0,1475,62,28,64,64,0,64,0,0,862,760,0,746,14,102,130,5.2,1.8,0.0,11.8,344413.734375,2476.92119213156
50161,11373,11373,36081049900,462388,0,Census Tract 499,New York,Queens County,2613,4501,2925,2687,0,2481,132,74,238,238,0,222,16,0,1576,1345,0,1298,47,231,305,6.8,2.8,0.0,14.7,806041.84375,4123.59598960396
50162,11423,11423,36081050000,336068,0,Census Tract 500,New York,Queens County,2148,3221,2474,2283,0,1881,267,135,191,121,0,65,56,70,747,634,0,579,55,113,318,9.9,5.9,36.6,15.1,585503.32421875,4393.50703780193
50163,11423,11423,36081050201,168128,0,Census Tract 502.01,New York,Queens County,866,1238,883,866,0,815,51,0,17,17,0,17,0,0,355,346,0,329,17,9,9,0.7,0.0,0.0,2.5,292890.23046875,2228.59793251815
50164,11423,11423,36081050202,152854,0,Census Tract 502.02,New York,Queens County,708,1132,802,731,0,638,70,23,71,71,0,71,0,0,330,302,0,255,47,28,51,4.5,3.1,0.0,8.5,266288.9921875,2102.54348416592
50165,11412,11412,36081050400,216307,0,Census Tract 504,New York,Queens County,1047,1647,1215,1081,11,1015,21,34,134,111,0,111,0,23,432,375,0,333,42,57,114,6.9,3.1,17.2,13.2,376777.19140625,2516.54697436371
50166,11373,11373,36081050500,116113,0,Census Tract 505,New York,Queens County,782,1207,843,782,0,736,46,0,61,61,0,61,0,0,364,285,0,255,30,79,79,6.5,0.0,0.0,21.7,202400.171875,1834.75829959231
50166,11374,11374,36081050500,116113,0,Census Tract 505,New York,Queens County,782,1207,843,782,0,736,46,0,61,61,0,61,0,0,364,285,0,255,30,79,79,6.5,0.0,0.0,21.7,202400.171875,1834.75829959231
50166,11379,11379,36081050500,116113,0,Census Tract 505,New York,Queens County,782,1207,843,782,0,736,46,0,61,61,0,61,0,0,364,285,0,255,30,79,79,6.5,0.0,0.0,21.7,202400.171875,1834.75829959231
50167,11412,11412,36081050600,206128,0,Census Tract 506,New York,Queens County,757,1259,798,757,0,657,100,0,41,41,0,41,0,0,461,396,0,319,77,65,65,5.2,0.0,0.0,14.1,359056.80859375,2489.9018812413897
50168,11373,11373,36081050700,372217,0,Census Tract 507,New York,Queens County,2073,3424,2403,2235,0,1883,190,162,168,154,0,128,26,14,1021,914,0,878,36,107,283,8.3,7.2,8.3,10.5,648781.7890625,3543.5209160763397
50168,11379,11379,36081050700,372217,0,Census Tract 507,New York,Queens County,2073,3424,2403,2235,0,1883,190,162,168,154,0,128,26,14,1021,914,0,878,36,107,283,8.3,7.2,8.3,10.5,648781.7890625,3543.5209160763397
50169,11412,11412,36081050800,219531,0,Census Tract 508,New York,Queens County,870,1564,1000,908,0,705,165,38,92,74,0,51,23,18,564,482,0,406,76,82,138,8.8,4.2,19.6,14.5,382413.8984375,2546.82324938174
50170,11412,11412,36081051000,184889,0,Census Tract 510,New York,Queens County,812,1332,885,829,29,733,50,17,56,56,0,48,8,0,447,402,0,328,74,45,62,4.7,2.1,0.0,10.1,322096.5234375,3131.19370664927
50170,11423,11423,36081051000,184889,0,Census Tract 510,New York,Queens County,812,1332,885,829,29,733,50,17,56,56,0,48,8,0,447,402,0,328,74,45,62,4.7,2.1,0.0,10.1,322096.5234375,3131.19370664927
50170,11429,11429,36081051000,184889,0,Census Tract 510,New York,Queens County,812,1332,885,829,29,733,50,17,56,56,0,48,8,0,447,402,0,328,74,45,62,4.7,2.1,0.0,10.1,322096.5234375,3131.19370664927
50171,11378,11378,36081051100,273907,0,Census Tract 511,New York,Queens County,1016,1705,1121,1059,0,951,65,43,62,56,0,50,6,6,584,470,0,445,25,114,163,9.6,4.1,9.7,19.5,477421.390625,3727.0100906742296
50172,11428,11428,36081051200,375794,0,Census Tract 512,New York,Queens County,1242,2149,1444,1249,0,1175,67,7,195,195,0,180,15,0,705,626,0,620,6,79,86,4.0,0.6,0.0,11.2,654685.703125,4218.0325473494295
50172,11429,11429,36081051200,375794,0,Census Tract 512,New York,Queens County,1242,2149,1444,1249,0,1175,67,7,195,195,0,180,15,0,705,626,0,620,6,79,86,4.0,0.6,0.0,11.2,654685.703125,4218.0325473494295
50173,11377,11377,36081051300,193535,0,Census Tract 513,New York,Queens County,1088,1764,1149,1104,0,1021,67,16,45,45,0,45,0,0,615,584,0,547,37,31,47,2.7,1.4,0.0,5.0,337383.38671875,2626.2429298951897
50173,11378,11378,36081051300,193535,0,Census Tract 513,New York,Queens County,1088,1764,1149,1104,0,1021,67,16,45,45,0,45,0,0,615,584,0,547,37,31,47,2.7,1.4,0.0,5.0,337383.38671875,2626.2429298951897
50174,11377,11377,36081051500,224365,0,Census Tract 515,New York,Queens County,1440,2717,1603,1522,0,1368,72,82,81,81,0,69,12,0,1114,1011,0,940,71,103,185,6.8,5.4,0.0,9.2,391117.19921875,3208.88648988768
50174,11378,11378,36081051500,224365,0,Census Tract 515,New York,Queens County,1440,2717,1603,1522,0,1368,72,82,81,81,0,69,12,0,1114,1011,0,940,71,103,185,6.8,5.4,0.0,9.2,391117.19921875,3208.88648988768
50175,11411,11411,36081051600,184315,0,Census Tract 516,New York,Queens County,843,1671,1085,869,9,757,77,26,216,216,7,174,35,0,586,563,6,432,125,23,49,2.9,3.0,0.0,3.9,321034.58984375,2872.44146917159
50175,11429,11429,36081051600,184315,0,Census Tract 516,New York,Queens County,843,1671,1085,869,9,757,77,26,216,216,7,174,35,0,586,563,6,432,125,23,49,2.9,3.0,0.0,3.9,321034.58984375,2872.44146917159
50176,11378,11378,36081051700,254179,0,Census Tract 517,New York,Queens County,966,1618,1021,985,0,919,47,19,36,36,0,36,0,0,597,566,0,502,64,31,50,3.1,1.9,0.0,5.2,442999.8125,3974.5507617295098
50177,11412,11412,36081051800,169821,0,Census Tract 518,New York,Queens County,1053,1811,1245,1104,0,982,71,51,141,120,0,116,4,21,566,520,0,470,50,46,118,6.5,4.6,14.9,8.1,295778.53125,2515.6795514824303
50178,11412,11412,36081052000,172214,0,Census Tract 520,New York,Queens County,837,1183,873,837,28,776,33,0,36,36,0,27,9,0,310,298,11,283,4,12,12,1.0,0.0,0.0,3.9,299934.9140625,2524.34977864136
50179,11378,11378,36081052100,190269,0,Census Tract 521,New York,Queens County,1067,1906,1294,1256,5,1023,39,189,38,38,0,38,0,0,612,526,0,487,39,86,275,14.4,15.0,0.0,14.1,331580.25,2932.95070829966
50180,11412,11412,36081052200,169840,0,Census Tract 522,New York,Queens County,779,1281,835,820,0,744,35,41,15,15,0,15,0,0,446,358,0,351,7,88,129,10.1,5.0,0.0,19.7,295797.6328125,2515.37124848267
50181,11412,11412,36081052400,196181,0,Census Tract 524,New York,Queens County,805,1407,961,904,0,762,43,99,57,48,0,39,9,9,446,350,0,276,74,96,204,14.5,11.0,15.8,21.5,341685.14453125,2452.60880053433
50182,11378,11378,36081052500,202105,0,Census Tract 525,New York,Queens County,1065,1786,1182,1121,0,1065,0,56,61,61,0,61,0,0,604,477,0,461,16,127,183,10.2,5.0,0.0,21.0,352186.10546875,2590.16477241158
50183,11412,11412,36081052600,182575,0,Census Tract 526,New York,Queens County,951,1567,1050,951,48,829,74,0,99,94,13,68,13,5,517,469,22,333,114,48,53,3.4,0.0,5.1,9.3,317945.8203125,2345.36593593675
50184,11412,11412,36081052800,180396,0,Census Tract 528,New York,Queens County,550,1046,640,585,0,490,60,35,55,55,0,43,12,0,406,320,0,287,33,86,121,11.6,6.0,0.0,21.2,314120.93359375,2807.14598386308
50185,11412,11412,36081053000,230158,0,Census Tract 530,New York,Queens County,1207,2024,1294,1226,0,1098,109,19,68,68,0,68,0,0,730,703,0,638,65,27,46,2.3,1.5,0.0,3.7,400801.47265625,2560.84675974494
50186,11378,11378,36081053100,423497,0,Census Tract 531,New York,Queens County,1665,2726,1885,1697,5,1610,50,32,188,165,0,165,0,23,841,687,14,615,58,154,209,7.7,1.9,12.2,18.3,738071.13671875,3520.08400373701
50187,11412,11412,36081053200,189804,0,Census Tract 532,New York,Queens County,820,1538,976,893,0,783,37,73,83,77,0,66,11,6,562,524,9,504,11,38,117,7.6,8.2,7.2,6.8,330564.5546875,3539.23106186864
50188,11411,11411,36081053401,260260,0,Census Tract 534.01,New York,Queens County,1031,1901,1120,1050,0,1006,25,19,70,70,0,70,0,0,781,680,0,643,37,101,120,6.3,1.8,0.0,12.9,453270.4296875,3212.8149379017605
50188,11429,11429,36081053401,260260,0,Census Tract 534.01,New York,Queens County,1031,1901,1120,1050,0,1006,25,19,70,70,0,70,0,0,781,680,0,643,37,101,120,6.3,1.8,0.0,12.9,453270.4296875,3212.8149379017605
50189,11378,11378,36081053500,502656,14162,Census Tract 535,New York,Queens County,580,1045,690,637,0,439,141,57,53,41,0,41,0,12,355,235,0,130,105,120,189,18.1,8.9,22.6,33.8,884831.265625,4627.09704375252
50189,11385,11385,36081053500,502656,14162,Census Tract 535,New York,Queens County,580,1045,690,637,0,439,141,57,53,41,0,41,0,12,355,235,0,130,105,120,189,18.1,8.9,22.6,33.8,884831.265625,4627.09704375252
50190,11429,11429,36081053601,190875,0,Census Tract 536.01,New York,Queens County,952,1670,1173,974,0,935,17,22,199,187,0,175,12,12,497,450,0,405,45,47,81,4.9,2.3,6.0,9.5,332494.41796875,2680.5822847043696
50191,11429,11429,36081053800,188754,0,Census Tract 538,New York,Queens County,917,1432,1016,934,0,831,86,17,82,82,0,72,10,0,416,373,0,313,60,43,60,4.2,1.8,0.0,10.3,328797.671875,2896.938803855
50192,11385,11385,36081053900,604540,0,Census Tract 539,New York,Queens County,2262,3724,2498,2332,0,2040,222,70,166,157,0,143,14,9,1226,980,0,877,103,246,325,8.7,3.0,5.4,20.1,1053194.1953125,4496.24912322467
50193,11428,11428,36081054000,522713,0,Census Tract 540,New York,Queens County,2253,3696,2602,2296,0,2014,239,43,306,306,0,292,14,0,1094,974,0,831,143,120,163,4.4,1.9,0.0,11.0,910705.3125,4163.66443207152
50193,11429,11429,36081054000,522713,0,Census Tract 540,New York,Queens County,2253,3696,2602,2296,0,2014,239,43,306,306,0,292,14,0,1094,974,0,831,143,120,163,4.4,1.9,0.0,11.0,910705.3125,4163.66443207152
50194,11428,11428,36081054200,541845,0,Census Tract 542,New York,Queens County,2366,4013,2676,2527,0,2193,173,161,149,149,0,142,7,0,1337,1189,0,1118,71,148,309,7.7,6.4,0.0,11.1,944213.16015625,4032.3791221699394
50195,11385,11385,36081054500,113474,0,Census Tract 545,New York,Queens County,2175,3137,2316,2193,11,1750,414,18,123,123,0,104,19,0,821,770,13,568,189,51,69,2.2,0.8,0.0,6.2,197660.0234375,1801.82150496937
50196,11385,11385,36081054700,129153,0,Census Tract 547,New York,Queens County,2571,4216,2822,2691,0,2146,425,120,131,131,0,124,7,0,1394,1249,7,1079,163,145,265,6.3,4.5,0.0,10.4,224959.33984375,2202.02684820134
50197,11427,11427,36081054800,225673,0,Census Tract 548,New York,Queens County,1120,1942,1259,1175,0,1067,53,55,84,84,0,75,9,0,683,640,0,586,54,43,98,5.0,4.7,0.0,6.3,393303.19921875,2846.12600714886
50198,11385,11385,36081054900,164280,0,Census Tract 549,New York,Queens County,2987,4590,3364,3193,0,2503,484,206,171,171,0,171,0,0,1226,1096,0,865,231,130,336,7.3,6.5,0.0,10.6,286129.65234375,2479.8797764330398
50199,11385,11385,36081055100,155133,0,Census Tract 551,New York,Queens County,2127,3411,2454,2312,0,1876,251,185,142,109,0,66,43,33,957,718,0,598,120,239,457,13.4,8.0,23.2,25.0,270195.6015625,2401.98805960785
50200,11427,11427,36081055200,417515,0,Census Tract 552,New York,Queens County,1521,2497,1707,1628,0,1511,10,107,79,79,0,75,4,0,790,540,0,540,0,250,357,14.3,6.6,0.0,31.6,727746.84375,4403.95366425443
50201,11385,11385,36081055300,137026,0,Census Tract 553,New York,Queens County,1278,2154,1337,1299,0,1052,226,21,38,38,0,38,0,0,817,683,0,582,101,134,155,7.2,1.6,0.0,16.4,238636.40625,2326.10556232748
50202,11427,11427,36081055400,220076,0,Census Tract 554,New York,Queens County,1039,1893,1210,1158,0,1032,7,119,52,52,0,52,0,0,683,572,0,555,17,111,230,12.2,10.3,0.0,16.3,383604.984375,2735.3539633630103
50202,11428,11428,36081055400,220076,0,Census Tract 554,New York,Queens County,1039,1893,1210,1158,0,1032,7,119,52,52,0,52,0,0,683,572,0,555,17,111,230,12.2,10.3,0.0,16.3,383604.984375,2735.3539633630103
50203,11385,11385,36081055500,153716,0,Census Tract 555,New York,Queens County,1090,1783,1163,1147,0,1022,68,57,16,16,0,16,0,0,620,599,0,552,47,21,78,4.4,5.0,0.0,3.4,267690.90234375,2557.56681990467
50204,11427,11427,36081055600,226903,0,Census Tract 556,New York,Queens County,1073,1864,1109,1073,0,1059,14,0,36,36,0,36,0,0,755,731,0,709,22,24,24,1.3,0.0,0.0,3.2,395476.38671875,2510.0134733167
50204,11428,11428,36081055600,226903,0,Census Tract 556,New York,Queens County,1073,1864,1109,1073,0,1059,14,0,36,36,0,36,0,0,755,731,0,709,22,24,24,1.3,0.0,0.0,3.2,395476.38671875,2510.0134733167
50205,11385,11385,36081055700,238756,0,Census Tract 557,New York,Queens County,2326,3439,2450,2326,0,2194,132,0,124,101,0,101,0,23,989,771,0,731,40,218,241,7.0,0.0,18.5,22.0,415800.796875,3189.1492208526897
50206,11428,11428,36081055800,192360,0,Census Tract 558,New York,Queens County,893,1489,931,893,0,858,35,0,38,32,0,32,0,6,558,492,0,462,30,66,72,4.8,0.0,15.8,11.8,335241.08984375,2336.47384622296
50207,11385,11385,36081055900,158575,0,Census Tract 559,New York,Queens County,621,893,668,644,0,607,14,23,24,24,0,24,0,0,225,223,0,212,11,2,25,2.8,3.6,0.0,0.9,276128.5,2273.3900637745
50208,11428,11428,36081056000,213438,0,Census Tract 560,New York,Queens County,758,1419,806,758,0,744,14,0,48,48,0,44,4,0,613,561,0,502,59,52,52,3.7,0.0,0.0,8.5,372007.1015625,3417.3497987023197
50209,11385,11385,36081056100,2829081,82983,Census Tract 561,New York,Queens County,38,55,38,38,0,28,10,0,0,0,0,0,0,0,17,17,0,13,4,0,0,0.0,0.0,,0.0,5070617.2734375,13107.581915628702
50210,11428,11428,36081056200,160598,0,Census Tract 562,New York,Queens County,871,1479,968,898,0,847,24,27,70,70,0,70,0,0,511,461,0,450,11,50,77,5.2,3.0,0.0,9.8,279903.76171875,2330.04677851618
50211,11426,11426,36081056400,187147,0,Census Tract 564,New York,Queens County,543,1021,592,565,0,509,34,22,27,27,0,12,15,0,429,346,0,329,17,83,105,10.3,3.9,0.0,19.3,326143.58203125,2817.7348258763896
50211,11428,11428,36081056400,187147,0,Census Tract 564,New York,Queens County,543,1021,592,565,0,509,34,22,27,27,0,12,15,0,429,346,0,329,17,83,105,10.3,3.9,0.0,19.3,326143.58203125,2817.7348258763896
50212,11385,11385,36081056500,117784,0,Census Tract 565,New York,Queens County,727,1135,793,763,0,639,88,36,30,30,0,30,0,0,342,325,0,258,67,17,53,4.7,4.7,0.0,5.0,205099.34765625,2691.41907552672
50213,11428,11428,36081056600,194134,0,Census Tract 566,New York,Queens County,810,1294,851,821,0,794,16,11,30,30,0,30,0,0,443,428,0,410,18,15,26,2.0,1.3,0.0,3.4,338307.6171875,2296.39191125148
50214,11385,11385,36081056700,313429,0,Census Tract 567,New York,Queens County,2616,4010,2840,2787,0,2584,32,171,53,53,0,53,0,0,1170,977,0,942,35,193,364,9.1,6.1,0.0,16.5,545821.1796875,4601.46655560707
50215,11428,11428,36081056800,850869,0,Census Tract 568,New York,Queens County,2370,4115,2956,2402,0,2370,0,32,554,536,0,536,0,18,1159,1052,0,977,75,107,157,3.8,1.3,3.2,9.2,1482569.03125,6328.47163219522
50215,11429,11429,36081056800,850869,0,Census Tract 568,New York,Queens County,2370,4115,2956,2402,0,2370,0,32,554,536,0,536,0,18,1159,1052,0,977,75,107,157,3.8,1.3,3.2,9.2,1482569.03125,6328.47163219522
50216,11385,11385,36081057700,186600,0,Census Tract 577,New York,Queens County,1812,3488,1957,1853,0,1677,135,41,104,104,0,104,0,0,1531,1371,0,1322,49,160,201,5.8,2.2,0.0,10.5,324987.2265625,2594.68340450233
50217,11385,11385,36081057900,68348,0,Census Tract 579,New York,Queens County,849,1429,912,856,0,811,38,7,56,56,0,56,0,0,517,473,0,433,40,44,51,3.6,0.8,0.0,8.5,119048.33984375,1636.5058394018201
50218,11003,11411,36081058000,550452,0,Census Tract 580,New York,Queens County,1925,3181,2194,1943,0,1866,59,18,251,251,0,226,25,0,987,941,0,789,152,46,64,2.0,0.9,0.0,4.7,958873.02734375,4837.20621603333
50218,11429,11429,36081058000,550452,0,Census Tract 580,New York,Queens County,1925,3181,2194,1943,0,1866,59,18,251,251,0,226,25,0,987,941,0,789,152,46,64,2.0,0.9,0.0,4.7,958873.02734375,4837.20621603333
50219,11385,11385,36081058100,143606,0,Census Tract 581,New York,Queens County,1476,2304,1577,1540,0,1476,0,64,37,37,0,37,0,0,727,686,0,625,61,41,105,4.6,4.2,0.0,5.6,250131.1171875,2263.40975767624
50220,11429,11429,36081058200,563649,0,Census Tract 582,New York,Queens County,2504,3958,2855,2542,0,2366,138,38,313,313,0,287,26,0,1103,1060,0,892,168,43,81,2.0,1.5,0.0,3.9,981856.4921875,4603.1548890595
50221,11385,11385,36081058300,143113,0,Census Tract 583,New York,Queens County,1886,2894,1961,1898,8,1822,56,12,63,63,0,63,0,0,933,829,20,717,92,104,116,4.0,0.6,0.0,11.1,249261.8828125,2066.86292913128
50222,11385,11385,36081058500,171163,0,Census Tract 585,New York,Queens County,2237,3398,2318,2245,0,2022,215,8,73,73,0,73,0,0,1080,920,0,813,107,160,168,4.9,0.4,0.0,14.8,298136.6484375,2260.42979379746
50223,11385,11385,36081058700,144531,0,Census Tract 587,New York,Queens County,1832,2750,1860,1832,11,1684,137,0,28,28,0,28,0,0,890,752,0,648,104,138,138,5.0,0.0,0.0,15.5,251770.3515625,2057.1579987785
50224,11385,11385,36081058900,165272,0,Census Tract 589,New York,Queens County,2382,3883,2576,2468,0,2219,163,86,108,84,0,84,0,24,1307,1134,0,951,183,173,283,7.3,3.5,22.2,13.2,287892.75,2254.46401878902
50225,11411,11411,36081059000,158600,0,Census Tract 590,New York,Queens County,724,1323,804,729,32,659,33,5,75,75,0,75,0,0,519,514,28,478,8,5,10,0.8,0.7,0.0,1.0,276227.09765625,2419.36228452517
50225,11429,11429,36081059000,158600,0,Census Tract 590,New York,Queens County,724,1323,804,729,32,659,33,5,75,75,0,75,0,0,519,514,28,478,8,5,10,0.8,0.7,0.0,1.0,276227.09765625,2419.36228452517
50226,11385,11385,36081059100,202060,0,Census Tract 591,New York,Queens County,2870,4455,3273,3106,0,2470,400,236,167,167,0,167,0,0,1182,910,0,838,72,272,508,11.4,7.6,0.0,23.0,351990.16796875,2517.80602353553
50227,11003,11411,36081059200,226137,0,Census Tract 592,New York,Queens County,732,1233,885,797,0,693,39,65,88,51,0,40,11,37,348,303,0,277,26,45,147,11.9,8.2,42.0,12.9,393853.00390625,3503.03846727224
50227,11411,11411,36081059200,226137,0,Census Tract 592,New York,Queens County,732,1233,885,797,0,693,39,65,88,51,0,40,11,37,348,303,0,277,26,45,147,11.9,8.2,42.0,12.9,393853.00390625,3503.03846727224
50227,11429,11429,36081059200,226137,0,Census Tract 592,New York,Queens County,732,1233,885,797,0,693,39,65,88,51,0,40,11,37,348,303,0,277,26,45,147,11.9,8.2,42.0,12.9,393853.00390625,3503.03846727224
50228,11385,11385,36081059300,252144,0,Census Tract 593,New York,Queens County,2203,3552,2410,2245,0,2030,173,42,165,165,0,149,16,0,1142,895,0,824,71,247,289,8.1,1.9,0.0,21.6,439269.06640625,2872.8460048584498
50229,11411,11411,36081059400,222046,0,Census Tract 594,New York,Queens County,956,1598,1061,1001,13,895,48,45,60,60,0,60,0,0,537,487,20,432,35,50,95,5.9,4.5,0.0,9.3,386697.84375,2832.13223785672
50230,11378,11378,36081059500,396049,0,Census Tract 595,New York,Queens County,2530,4164,2856,2574,32,2375,123,44,282,269,10,259,0,13,1308,1213,39,1026,148,95,152,3.7,1.7,4.6,7.3,690040.1015625,4009.2850453651
50230,11385,11385,36081059500,396049,0,Census Tract 595,New York,Queens County,2530,4164,2856,2574,32,2375,123,44,282,269,10,259,0,13,1308,1213,39,1026,148,95,152,3.7,1.7,4.6,7.3,690040.1015625,4009.2850453651
50231,11411,11411,36081059600,194550,0,Census Tract 596,New York,Queens County,700,1113,775,700,0,692,8,0,75,53,0,53,0,22,338,321,0,308,13,17,39,3.5,0.0,29.3,5.0,338801.2578125,2450.5339852944
50232,11411,11411,36081059800,206471,0,Census Tract 598,New York,Queens County,943,1417,988,966,18,836,89,23,22,22,0,15,7,0,429,380,14,299,67,49,72,5.1,2.4,0.0,11.4,359574.12109375,2472.97648410201
50233,11378,11378,36081059900,127081,0,Census Tract 599,New York,Queens County,639,1112,701,639,8,631,0,0,62,62,0,62,0,0,411,356,0,333,23,55,55,4.9,0.0,0.0,13.4,221438.96484375,2501.04166545314
50234,11411,11411,36081060000,176717,0,Census Tract 600,New York,Queens County,587,1008,651,618,0,587,0,31,33,33,0,33,0,0,357,272,0,265,7,85,116,11.5,5.0,0.0,23.8,307727.56640625,2326.12441011325
50235,11378,11378,36081060100,154428,0,Census Tract 601,New York,Queens County,880,1583,944,917,0,853,27,37,27,27,0,21,6,0,639,555,0,539,16,84,121,7.6,4.0,0.0,13.1,269073.84765625,2540.91929393994
50235,11379,11379,36081060100,154428,0,Census Tract 601,New York,Queens County,880,1583,944,917,0,853,27,37,27,27,0,21,6,0,639,555,0,539,16,84,121,7.6,4.0,0.0,13.1,269073.84765625,2540.91929393994
50236,11379,11379,36081060300,181368,0,Census Tract 603,New York,Queens County,1052,1704,1147,1102,0,1023,29,50,45,40,0,40,0,5,557,492,0,445,47,65,120,7.0,4.5,11.1,11.7,316000.85546875,2687.18916541129
50236,11385,11385,36081060300,181368,0,Census Tract 603,New York,Queens County,1052,1704,1147,1102,0,1023,29,50,45,40,0,40,0,5,557,492,0,445,47,65,120,7.0,4.5,11.1,11.7,316000.85546875,2687.18916541129
50237,11411,11411,36081060600,215296,0,Census Tract 606,New York,Queens County,686,1189,720,706,0,686,0,20,14,14,0,14,0,0,469,437,11,386,40,32,52,4.4,2.8,0.0,6.8,374864.9921875,2485.30707820712
50238,11378,11378,36081060701,712989,0,Census Tract 607.01,New York,Queens County,28,36,28,28,0,28,0,0,0,0,0,0,0,0,8,8,0,8,0,0,0,0.0,0.0,,0.0,1242383.0078125,7654.42622808515
50238,11379,11379,36081060701,712989,0,Census Tract 607.01,New York,Queens County,28,36,28,28,0,28,0,0,0,0,0,0,0,0,8,8,0,8,0,0,0,0.0,0.0,,0.0,1242383.0078125,7654.42622808515
50239,11411,11411,36081060800,211446,0,Census Tract 608,New York,Queens County,825,1503,915,891,6,775,44,66,24,24,0,18,6,0,588,524,0,486,38,64,130,8.6,7.4,0.0,10.9,368187.1015625,2483.48599723395
50240,11411,11411,36081061000,236865,0,Census Tract 610,New York,Queens County,695,1251,780,708,0,660,35,13,72,72,0,72,0,0,471,405,0,324,81,66,79,6.3,1.8,0.0,14.0,412407.1015625,2596.1773714752303
50241,11411,11411,36081061200,262496,0,Census Tract 612,New York,Queens County,1129,1626,1213,1148,0,1110,19,19,65,60,0,60,0,5,413,413,0,397,16,0,24,1.5,1.7,7.7,0.0,457005.07421875,2824.9597650686
50242,11379,11379,36081061301,712703,0,Census Tract 613.01,New York,Queens County,3009,5083,3413,3151,9,2749,251,142,262,262,0,262,0,0,1670,1378,25,1185,168,292,434,8.5,4.5,0.0,17.5,1241574.54296875,6247.90653726341
50242,11385,11385,36081061301,712703,0,Census Tract 613.01,New York,Queens County,3009,5083,3413,3151,9,2749,251,142,262,262,0,262,0,0,1670,1378,25,1185,168,292,434,8.5,4.5,0.0,17.5,1241574.54296875,6247.90653726341
50243,11379,11379,36081061302,487033,0,Census Tract 613.02,New York,Queens County,0,0,0,0,0,0,0,0,0,0,0,0,0,0,0,0,0,0,0,0,0,,,,,848452.48828125,4077.9143491407794
50244,11411,11411,36081061400,257752,0,Census Tract 614,New York,Queens County,629,1114,692,629,0,590,39,0,63,63,0,35,28,0,422,409,6,374,29,13,13,1.2,0.0,0.0,3.1,448718.41796875,2790.69099055979
50245,11413,11413,36081061601,380215,0,Census Tract 616.01,New York,Queens County,1083,1908,1157,1112,0,920,163,29,45,37,0,37,0,8,751,706,0,542,164,45,82,4.3,2.6,17.8,6.0,661820.46875,3525.4261718105
50245,11422,11422,36081061601,380215,0,Census Tract 616.01,New York,Queens County,1083,1908,1157,1112,0,920,163,29,45,37,0,37,0,8,751,706,0,542,164,45,82,4.3,2.6,17.8,6.0,661820.46875,3525.4261718105
50246,11422,11422,36081061602,422309,0,Census Tract 616.02,New York,Queens County,597,1071,607,602,0,585,12,5,5,5,0,5,0,0,464,437,0,427,10,27,32,3.0,0.8,0.0,5.8,735007.73046875,4050.4975686046796
50247,11413,11413,36081061800,241542,0,Census Tract 618,New York,Queens County,895,1460,951,911,0,820,75,16,40,40,0,40,0,0,509,431,7,369,55,78,94,6.4,1.8,0.0,15.3,420382.01171875,2674.0442301948897
50247,11422,11422,36081061800,241542,0,Census Tract 618,New York,Queens County,895,1460,951,911,0,820,75,16,40,40,0,40,0,0,509,431,7,369,55,78,94,6.4,1.8,0.0,15.3,420382.01171875,2674.0442301948897
50248,11379,11379,36081061900,257858,0,Census Tract 619,New York,Queens County,1262,2368,1385,1290,0,1226,36,28,95,95,0,95,0,0,983,786,0,723,63,197,225,9.5,2.2,0.0,20.0,449215.8671875,3634.9401682922
50249,11413,11413,36081062000,216234,0,Census Tract 620,New York,Queens County,547,1140,582,573,0,467,80,26,9,9,0,9,0,0,558,462,0,409,53,96,122,10.7,4.5,0.0,17.2,376381.33203125,2624.90423269981
50250,11379,11379,36081062100,258272,0,Census Tract 621,New York,Queens County,1263,2094,1333,1285,0,1135,128,22,48,48,0,48,0,0,761,663,0,603,60,98,120,5.7,1.7,0.0,12.9,449937.99609375,3058.5303329555895
50250,11385,11385,36081062100,258272,0,Census Tract 621,New York,Queens County,1263,2094,1333,1285,0,1135,128,22,48,48,0,48,0,0,761,663,0,603,60,98,120,5.7,1.7,0.0,12.9,449937.99609375,3058.5303329555895
50251,11411,11411,36081062200,437270,0,Census Tract 622,New York,Queens County,970,1717,1067,988,0,956,14,18,79,79,0,79,0,0,650,592,0,592,0,58,76,4.4,1.8,0.0,8.9,761370.875,4116.47693134591
50252,11385,11385,36081062300,156656,0,Census Tract 623,New York,Queens County,1109,1694,1161,1140,0,1082,27,31,21,21,0,10,11,0,533,421,0,391,30,112,143,8.4,2.7,0.0,21.0,272870.5,2213.0679335157
50253,11413,11413,36081062400,512105,0,Census Tract 624,New York,Queens County,0,0,0,0,0,0,0,0,0,0,0,0,0,0,0,0,0,0,0,0,0,,,,,891502.21875,4640.78028768393
50254,11385,11385,36081062500,198779,0,Census Tract 625,New York,Queens County,1498,2265,1626,1523,0,1462,36,25,103,103,0,103,0,0,639,610,0,590,20,29,54,2.4,1.6,0.0,4.5,346236.6171875,2399.2553476670396
50255,11413,11413,36081062600,429396,0,Census Tract 626,New York,Queens County,1463,2296,1563,1474,0,1401,62,11,89,89,0,89,0,0,733,671,4,559,108,62,73,3.2,0.7,0.0,8.5,747437.625,3669.4244481016603
50256,11385,11385,36081062700,157306,0,Census Tract 627,New York,Queens County,1376,2296,1532,1454,52,1213,111,78,78,78,7,71,0,0,764,572,15,487,70,192,270,11.8,5.4,0.0,25.1,273996.30859375,2150.3805568368302
50257,11385,11385,36081062900,183530,0,Census Tract 629,New York,Queens County,1391,2274,1514,1398,0,1124,267,7,116,116,0,116,0,0,760,631,7,508,116,129,136,6.0,0.5,0.0,17.0,319643.12109375,3475.3804007042895
50258,11413,11413,36081063000,190477,0,Census Tract 630,New York,Queens County,801,1342,837,825,0,778,23,24,12,12,0,12,0,0,505,461,0,363,98,44,68,5.1,2.9,0.0,8.7,331541.53125,3386.08818900485
50259,11413,11413,36081063200,296790,0,Census Tract 632,New York,Queens County,1458,2313,1586,1487,0,1386,72,29,99,99,0,99,0,0,727,672,0,602,70,55,84,3.6,2.0,0.0,7.6,516529.0078125,3784.7578447184296
50259,11422,11422,36081063200,296790,0,Census Tract 632,New York,Queens County,1458,2313,1586,1487,0,1386,72,29,99,99,0,99,0,0,727,672,0,602,70,55,84,3.6,2.0,0.0,7.6,516529.0078125,3784.7578447184296
50260,11385,11385,36081063301,134735,0,Census Tract 633.01,New York,Queens County,790,1291,864,790,0,784,6,0,74,68,0,68,0,6,427,391,13,363,15,36,42,3.3,0.0,8.1,8.4,234684.5390625,2244.3414870553797
50261,11385,11385,36081063302,138739,0,Census Tract 633.02,New York,Queens County,687,1148,706,695,0,674,13,8,11,11,0,11,0,0,442,374,0,344,30,68,76,6.6,1.2,0.0,15.4,241666.8671875,2566.1770115891895
50262,11385,11385,36081063500,189460,0,Census Tract 635,New York,Queens County,1198,2133,1315,1242,5,1142,51,44,73,73,0,57,16,0,818,744,0,655,89,74,118,5.5,3.5,0.0,9.0,330009.125,2468.81987033289
50263,11374,11374,36081063700,695127,0,Census Tract 637,New York,Queens County,1710,2914,1782,1733,0,1555,155,23,49,33,0,33,0,16,1132,965,0,942,23,167,206,7.1,1.3,32.7,14.8,1210934.15234375,5048.72600337435
50263,11385,11385,36081063700,695127,0,Census Tract 637,New York,Queens County,1710,2914,1782,1733,0,1555,155,23,49,33,0,33,0,16,1132,965,0,942,23,167,206,7.1,1.3,32.7,14.8,1210934.15234375,5048.72600337435
50264,11422,11422,36081063800,688853,0,Census Tract 638,New York,Queens County,1924,2993,2090,1924,0,1729,195,0,166,166,0,166,0,0,903,855,0,731,124,48,48,1.6,0.0,0.0,5.3,1198626.546875,4930.384643898329
50265,11385,11385,36081063900,251775,0,Census Tract 639,New York,Queens County,1439,2495,1576,1509,0,1249,190,70,67,67,0,57,10,0,919,811,0,560,251,108,178,7.1,4.6,0.0,11.8,438545.3046875,3613.12731374865
50266,11421,11421,36081064101,82907,0,Census Tract 641.01,New York,Queens County,1024,1921,1093,1046,0,996,28,22,47,42,0,42,0,5,828,643,5,628,10,185,212,11.0,2.1,10.6,22.3,144388.24609375,1677.64268712072
50267,11418,11418,36081064102,2227925,0,Census Tract 641.02,New York,Queens County,0,0,0,0,0,0,0,0,0,0,0,0,0,0,0,0,0,0,0,0,0,,,,,3880397.8828125,11939.7562125201
50267,11421,11421,36081064102,2227925,0,Census Tract 641.02,New York,Queens County,0,0,0,0,0,0,0,0,0,0,0,0,0,0,0,0,0,0,0,0,0,,,,,3880397.8828125,11939.7562125201
50268,11375,11375,36081064500,309592,0,Census Tract 645,New York,Queens County,861,1642,1039,912,0,804,57,51,127,114,0,114,0,13,603,518,0,467,51,85,149,9.1,5.6,10.2,14.1,539332.94921875,3910.51492014906
50269,11413,11413,36081064600,407308,0,Census Tract 646,New York,Queens County,1488,2666,1709,1539,6,1365,117,51,170,150,0,150,0,20,957,827,4,763,60,130,201,7.5,3.3,11.8,13.6,708791.26171875,3697.93748630646
50269,11422,11422,36081064600,407308,0,Census Tract 646,New York,Queens County,1488,2666,1709,1539,6,1365,117,51,170,150,0,150,0,20,957,827,4,763,60,130,201,7.5,3.3,11.8,13.6,708791.26171875,3697.93748630646
50270,11413,11413,36081065000,399997,0,Census Tract 650,New York,Queens County,1422,2400,1620,1499,0,1379,43,77,121,114,0,114,0,7,780,735,0,629,106,45,129,5.4,5.1,5.8,5.8,696000.15234375,3720.68925937683
50270,11422,11422,36081065000,399997,0,Census Tract 650,New York,Queens County,1422,2400,1620,1499,0,1379,43,77,121,114,0,114,0,7,780,735,0,629,106,45,129,5.4,5.1,5.8,5.8,696000.15234375,3720.68925937683
50271,11413,11413,36081065400,683540,17661,Census Tract 654,New York,Queens County,1678,2575,1772,1699,0,1625,53,21,73,73,0,73,0,0,803,760,6,714,40,43,64,2.5,1.2,0.0,5.4,1219847.97265625,6611.58099114907
50271,11422,11422,36081065400,683540,17661,Census Tract 654,New York,Queens County,1678,2575,1772,1699,0,1625,53,21,73,73,0,73,0,0,803,760,6,714,40,43,64,2.5,1.2,0.0,5.4,1219847.97265625,6611.58099114907
50272,11379,11379,36081065501,812085,0,Census Tract 655.01,New York,Queens County,0,0,0,0,0,0,0,0,0,0,0,0,0,0,0,0,0,0,0,0,0,,,,,1414952.34765625,4697.84591366057
50273,11422,11422,36081065600,590500,0,Census Tract 656,New York,Queens County,2570,4115,2728,2579,0,2471,99,9,149,149,0,137,12,0,1387,1277,0,1203,74,110,119,2.9,0.3,0.0,7.9,1027183.25390625,6934.570071952719
50274,11379,11379,36081065702,144106,0,Census Tract 657.02,New York,Queens County,845,1539,957,863,0,813,32,18,94,94,0,77,17,0,582,477,0,422,55,105,123,8.0,2.1,0.0,18.0,251073.29296875,2694.95708554419
50275,11379,11379,36081065703,268451,0,Census Tract 657.03,New York,Queens County,1581,2400,1620,1593,0,1499,82,12,27,27,0,19,8,0,780,649,0,606,43,131,143,6.0,0.8,0.0,16.8,467744.453125,2957.6025519194895
50276,11379,11379,36081065900,193751,0,Census Tract 659,New York,Queens County,873,1438,944,905,0,779,94,32,39,39,0,26,13,0,494,444,0,406,38,50,82,5.7,3.5,0.0,10.1,337595.546875,3228.5187243094
50277,11422,11422,36081066000,386557,0,Census Tract 660,New York,Queens County,1659,2861,1704,1670,19,1537,103,11,34,34,0,34,0,0,1157,1047,0,997,50,110,121,4.2,0.7,0.0,9.5,672400.7734375,3427.02897230848
50278,11379,11379,36081066100,133576,0,Census Tract 661,New York,Queens County,719,1321,744,724,0,719,0,5,20,20,0,20,0,0,577,487,0,460,27,90,95,7.2,0.7,0.0,15.6,232760.3046875,2289.84652639757
50279,11379,11379,36081066300,524960,0,Census Tract 663,New York,Queens County,1289,2233,1356,1313,0,1237,52,24,43,43,0,43,0,0,877,794,25,765,4,83,107,4.8,1.8,0.0,9.5,914843.5078125,4627.24923684044
50280,11413,11413,36081066400,2809000,145671,Census Tract 664,New York,Queens County,4933,7800,5451,5063,0,4917,16,130,388,388,0,388,0,0,2349,2246,0,2139,107,103,233,3.0,2.6,0.0,4.4,5068994.7265625,16991.077844614
50280,11422,11422,36081066400,2809000,145671,Census Tract 664,New York,Queens County,4933,7800,5451,5063,0,4917,16,130,388,388,0,388,0,0,2349,2246,0,2139,107,103,233,3.0,2.6,0.0,4.4,5068994.7265625,16991.077844614
50281,11379,11379,36081066501,328021,0,Census Tract 665.01,New York,Queens County,2196,3229,2259,2219,0,2167,29,23,40,40,0,40,0,0,970,810,25,737,48,160,183,5.7,1.0,0.0,16.5,571609.62890625,4673.26280437658
50282,11378,11378,36081066701,252628,0,Census Tract 667.01,New York,Queens County,1152,2018,1215,1152,0,1126,26,0,63,63,0,63,0,0,803,606,0,586,20,197,197,9.8,0.0,0.0,24.5,440261.01171875,3086.22854170135
50282,11379,11379,36081066701,252628,0,Census Tract 667.01,New York,Queens County,1152,2018,1215,1152,0,1126,26,0,63,63,0,63,0,0,803,606,0,586,20,197,197,9.8,0.0,0.0,24.5,440261.01171875,3086.22854170135
50283,11378,11378,36081066900,160095,0,Census Tract 669,New York,Queens County,812,1373,864,818,0,726,86,6,46,46,0,46,0,0,509,415,10,366,39,94,100,7.3,0.7,0.0,18.5,279016.69140625,2421.8345328141395
50283,11379,11379,36081066900,160095,0,Census Tract 669,New York,Queens County,812,1373,864,818,0,726,86,6,46,46,0,46,0,0,509,415,10,366,39,94,100,7.3,0.7,0.0,18.5,279016.69140625,2421.8345328141395
50284,11379,11379,36081067100,229104,0,Census Tract 671,New York,Queens County,990,1931,1096,1028,0,967,23,38,68,68,0,68,0,0,835,685,0,644,41,150,188,9.7,3.7,0.0,18.0,399302.5234375,2975.1056046129997
50285,11379,11379,36081067700,185953,0,Census Tract 677,New York,Queens County,881,1525,953,903,0,879,2,22,50,45,0,45,0,5,572,514,4,509,1,58,85,5.6,2.4,10.0,10.1,324038.77734375,2684.1706371353303
50286,11374,11374,36081067900,253611,0,Census Tract 679,New York,Queens County,1829,2979,1982,1885,0,1589,240,56,97,97,0,66,31,0,997,867,0,810,57,130,186,6.2,3.0,0.0,13.0,442007.9140625,3668.03425094159
50286,11379,11379,36081067900,253611,0,Census Tract 679,New York,Queens County,1829,2979,1982,1885,0,1589,240,56,97,97,0,66,31,0,997,867,0,810,57,130,186,6.2,3.0,0.0,13.0,442007.9140625,3668.03425094159
50287,11413,11413,36081068000,764229,0,Census Tract 680,New York,Queens County,2482,4130,2644,2492,56,2185,241,10,152,152,0,124,28,0,1486,1476,0,1410,66,10,20,0.5,0.4,0.0,0.7,1329549.23046875,6011.256406036689
50288,11413,11413,36081068200,230135,0,Census Tract 682,New York,Queens County,561,829,589,565,0,545,16,4,24,24,0,24,0,0,240,226,0,214,12,14,18,2.2,0.7,0.0,5.8,400422.51171875,2907.50717241706
50289,11373,11373,36081068300,244391,0,Census Tract 683,New York,Queens County,2069,3629,2211,2076,0,2019,50,7,135,135,0,135,0,0,1418,1177,0,1149,28,241,248,6.8,0.3,0.0,17.0,426076.27734375,2759.63271779098
50290,11373,11373,36081068700,278499,0,Census Tract 687,New York,Queens County,2511,3977,2653,2536,0,2467,44,25,117,117,0,117,0,0,1324,1231,0,1203,28,93,118,3.0,1.0,0.0,7.0,485475.90625,3363.90100126782
50290,11374,11374,36081068700,278499,0,Census Tract 687,New York,Queens County,2511,3977,2653,2536,0,2467,44,25,117,117,0,117,0,0,1324,1231,0,1203,28,93,118,3.0,1.0,0.0,7.0,485475.90625,3363.90100126782
50291,11413,11413,36081069000,350534,0,Census Tract 690,New York,Queens County,1630,2760,1797,1667,24,1465,141,37,130,130,0,114,16,0,963,874,13,655,206,89,126,4.6,2.2,0.0,9.2,609773.41015625,3761.78930121711
50292,11374,11374,36081069300,142998,0,Census Tract 693,New York,Queens County,1397,2502,1534,1446,0,1357,40,49,88,88,0,64,24,0,968,768,0,768,0,200,249,10.0,3.4,0.0,20.7,249258.45703125,1976.32623803626
50293,11413,11413,36081069400,520067,4775,Census Tract 694,New York,Queens County,1894,2898,2050,1913,40,1761,93,19,137,97,10,79,8,40,848,783,0,744,39,65,124,4.3,1.0,29.2,7.7,912867.0234375,4883.59063543512
50293,11422,11422,36081069400,520067,4775,Census Tract 694,New York,Queens County,1894,2898,2050,1913,40,1761,93,19,137,97,10,79,8,40,848,783,0,744,39,65,124,4.3,1.0,29.2,7.7,912867.0234375,4883.59063543512
50294,11374,11374,36081069500,213219,0,Census Tract 695,New York,Queens County,1088,1778,1149,1103,0,1051,37,15,46,46,0,46,0,0,629,544,0,507,37,85,100,5.6,1.4,0.0,13.5,371628.9765625,2602.48772324506
50295,11374,11374,36081069701,132473,0,Census Tract 697.01,New York,Queens County,1942,3224,2122,2003,0,1883,59,61,119,119,0,119,0,0,1102,935,0,805,130,167,228,7.1,3.0,0.0,15.2,230900.19140625,2688.59735757041
50296,11374,11374,36081069702,441419,0,Census Tract 697.02,New York,Queens County,1611,2937,1672,1631,0,1558,53,20,41,41,0,41,0,0,1265,1002,19,892,91,263,283,9.6,1.2,0.0,20.8,769289.37890625,3605.2666684158503
50297,11374,11374,36081070300,241047,0,Census Tract 703,New York,Queens County,919,1610,965,925,0,861,58,6,40,34,0,34,0,6,645,540,0,512,28,105,117,7.3,0.6,15.0,16.3,420013.07421875,3727.83341865947
50298,11375,11375,36081070700,222061,0,Census Tract 707,New York,Queens County,1077,2041,1151,1111,0,1034,43,34,40,40,0,40,0,0,890,807,0,740,67,83,117,5.7,3.1,0.0,9.3,386912.9296875,2668.61738451094
50299,11375,11375,36081070900,219537,0,Census Tract 709,New York,Queens County,1385,2141,1517,1438,0,1358,27,53,79,79,0,79,0,0,624,547,0,532,15,77,130,6.1,3.7,0.0,12.3,382562.3828125,2982.9162674028003
50300,11374,11374,36081071100,375484,0,Census Tract 711,New York,Queens County,3152,5085,3426,3355,0,3050,102,203,71,71,0,71,0,0,1659,1512,0,1420,92,147,350,6.9,6.1,0.0,8.9,654376.91796875,5132.842685995561
50300,11375,11375,36081071100,375484,0,Census Tract 711,New York,Queens County,3152,5085,3426,3355,0,3050,102,203,71,71,0,71,0,0,1659,1512,0,1420,92,147,350,6.9,6.1,0.0,8.9,654376.91796875,5132.842685995561
50301,11375,11375,36081071303,140652,0,Census Tract 713.03,New York,Queens County,3303,4636,3358,3346,15,3235,53,43,12,12,0,12,0,0,1278,1087,54,1018,15,191,234,5.0,1.3,0.0,14.9,245150.18359375,2410.21265645328
50302,11374,11374,36081071304,154865,0,Census Tract 713.04,New York,Queens County,2966,5200,3213,3064,87,2731,148,98,149,149,0,149,0,0,1987,1612,61,1395,156,375,473,9.1,3.2,0.0,18.9,269945.88671875,2754.7227980071602
50302,11375,11375,36081071304,154865,0,Census Tract 713.04,New York,Queens County,2966,5200,3213,3064,87,2731,148,98,149,149,0,149,0,0,1987,1612,61,1395,156,375,473,9.1,3.2,0.0,18.9,269945.88671875,2754.7227980071602
50303,11375,11375,36081071305,135001,0,Census Tract 713.05,New York,Queens County,2688,4454,2763,2688,0,2576,112,0,75,75,0,75,0,0,1691,1439,0,1403,36,252,252,5.7,0.0,0.0,14.9,235285.97265625,2161.7710206269103
50304,11374,11374,36081071306,181329,0,Census Tract 713.06,New York,Queens County,3687,5437,3943,3717,0,3598,89,30,226,156,0,156,0,70,1494,1185,14,1136,35,309,409,7.5,0.8,31.0,20.7,316049.56640625,2502.12377188165
50304,11375,11375,36081071306,181329,0,Census Tract 713.06,New York,Queens County,3687,5437,3943,3717,0,3598,89,30,226,156,0,156,0,70,1494,1185,14,1136,35,309,409,7.5,0.8,31.0,20.7,316049.56640625,2502.12377188165
50305,11430,11434,36081071600,18319107,904474,Census Tract 716,New York,Queens County,0,0,0,0,0,0,0,0,0,0,0,0,0,0,0,0,0,0,0,0,0,,,,,31357688.7617188,35459.181477046004
50306,11374,11374,36081071701,190070,0,Census Tract 717.01,New York,Queens County,2433,4419,2589,2494,41,2334,58,61,95,95,44,38,13,0,1830,1252,82,1076,94,578,639,14.5,2.4,0.0,31.6,331333.421875,2679.65737652727
50307,11374,11374,36081071702,226987,0,Census Tract 717.02,New York,Queens County,1864,3317,1991,1924,9,1845,10,60,67,58,0,58,0,9,1326,955,0,872,83,371,440,13.3,3.1,13.4,28.0,395715.53515625,3090.9702428557202
50308,11374,11374,36081071900,165953,0,Census Tract 719,New York,Queens County,1067,2134,1203,1129,0,997,70,62,74,74,0,68,6,0,931,735,0,686,49,196,258,12.1,5.5,0.0,21.1,289328.12890625,2116.3476725871
50308,11375,11375,36081071900,165953,0,Census Tract 719,New York,Queens County,1067,2134,1203,1129,0,997,70,62,74,74,0,68,6,0,931,735,0,686,49,196,258,12.1,5.5,0.0,21.1,289328.12890625,2116.3476725871
50309,11374,11374,36081072100,170327,0,Census Tract 721,New York,Queens County,1999,4178,2342,2118,0,1954,45,119,224,173,0,173,0,51,1836,1604,0,1566,38,232,402,9.6,5.6,22.8,12.6,296920.16015625,2393.94041432094
50309,11375,11375,36081072100,170327,0,Census Tract 721,New York,Queens County,1999,4178,2342,2118,0,1954,45,119,224,173,0,173,0,51,1836,1604,0,1566,38,232,402,9.6,5.6,22.8,12.6,296920.16015625,2393.94041432094
50310,11375,11375,36081072300,470056,0,Census Tract 723,New York,Queens County,1074,1686,1149,1088,0,1053,21,14,61,61,0,61,0,0,537,434,0,427,7,103,117,6.9,1.3,0.0,19.2,819043.4453125,4189.013230575109
50311,11375,11375,36081072900,193731,0,Census Tract 729,New York,Queens County,703,1135,741,703,0,700,3,0,38,38,0,38,0,0,394,372,0,360,12,22,22,1.9,0.0,0.0,5.6,337529.171875,2346.81906555875
50312,11375,11375,36081073100,189843,0,Census Tract 731,New York,Queens County,667,1211,737,693,0,644,23,26,44,32,0,32,0,12,474,445,0,432,13,29,67,5.5,3.8,27.3,6.1,330739.7421875,2705.38118490434
50313,11375,11375,36081073700,210609,0,Census Tract 737,New York,Queens County,1001,1658,1051,1017,0,981,20,16,34,34,0,34,0,0,607,453,0,419,34,154,170,10.3,1.6,0.0,25.4,366997.91015625,2468.90840438987
50314,11375,11375,36081073900,224293,0,Census Tract 739,New York,Queens County,3153,4689,3439,3235,0,3137,16,82,204,156,0,156,0,48,1250,1080,0,1032,48,170,300,6.4,2.5,23.5,13.6,390905.1484375,2938.65009131648
50315,11375,11375,36081074100,172198,0,Census Tract 741,New York,Queens County,1623,2608,1723,1662,0,1574,49,39,61,54,0,54,0,7,885,692,0,618,74,193,239,9.2,2.3,11.5,21.8,300151.29296875,2296.3991747506197
50316,11375,11375,36081074300,193477,0,Census Tract 743,New York,Queens County,1928,3603,2145,2020,0,1854,74,92,125,125,0,125,0,0,1458,1221,0,1142,79,237,329,9.1,4.6,0.0,16.3,337283.96875,2316.9518995501603
50317,11375,11375,36081074500,174486,0,Census Tract 745,New York,Queens County,1765,3308,1963,1835,0,1692,73,70,128,128,0,118,10,0,1345,1054,0,1047,7,291,361,10.9,3.8,0.0,21.6,304214.65234375,2619.10279346244
50318,11375,11375,36081074700,295509,0,Census Tract 747,New York,Queens County,1428,2922,1747,1646,0,1260,168,218,101,101,0,101,0,0,1175,1060,0,997,63,115,333,11.4,13.2,0.0,9.8,515159.03125,4005.3528909170295
50319,11375,11375,36081074900,359060,0,Census Tract 749,New York,Queens County,650,1196,671,650,0,644,6,0,21,21,0,21,0,0,525,497,0,485,12,28,28,2.3,0.0,0.0,5.3,625594.53125,3205.7557649190803
50320,11375,11375,36081075701,197647,0,Census Tract 757.01,New York,Queens County,2873,4346,2985,2932,18,2794,61,59,53,53,0,53,0,0,1361,1096,35,1045,16,265,324,7.5,2.0,0.0,19.5,344407.03515625,3227.19368060775
50321,11375,11375,36081075702,352706,0,Census Tract 757.02,New York,Queens County,2168,3415,2283,2183,0,2133,35,15,100,100,0,100,0,0,1132,869,0,830,39,263,278,8.1,0.7,0.0,23.2,614715.234375,3586.6144718330497
50322,11375,11375,36081076901,181026,0,Census Tract 769.01,New York,Queens County,2293,3327,2441,2371,16,2219,58,78,70,70,0,70,0,0,886,712,7,680,25,174,252,7.6,3.3,0.0,19.6,315430.265625,3058.4991290473604
50323,11375,11375,36081076902,101240,0,Census Tract 769.02,New York,Queens County,672,1090,740,709,0,647,25,37,31,31,0,31,0,0,350,308,0,304,4,42,79,7.2,5.2,0.0,12.0,176399.8359375,1784.38458993095
50324,11415,11415,36081077300,279069,0,Census Tract 773,New York,Queens County,1190,1823,1222,1190,0,999,191,0,32,32,0,24,8,0,601,453,0,433,20,148,148,8.1,0.0,0.0,24.6,486186.8359375,3752.3794470151897
50324,11418,11418,36081077300,279069,0,Census Tract 773,New York,Queens County,1190,1823,1222,1190,0,999,191,0,32,32,0,24,8,0,601,453,0,433,20,148,148,8.1,0.0,0.0,24.6,486186.8359375,3752.3794470151897
50325,11415,11415,36081077500,229488,0,Census Tract 775,New York,Queens County,1231,2110,1270,1231,0,1231,0,0,39,39,0,39,0,0,840,768,0,757,11,72,72,3.4,0.0,0.0,8.6,399781.48046875,2942.8504022128805
50325,11418,11418,36081077500,229488,0,Census Tract 775,New York,Queens County,1231,2110,1270,1231,0,1231,0,0,39,39,0,39,0,0,840,768,0,757,11,72,72,3.4,0.0,0.0,8.6,399781.48046875,2942.8504022128805
50326,11367,11367,36081077902,559114,0,Census Tract 779.02,New York,Queens County,2034,3327,2155,2034,16,1827,191,0,121,121,0,121,0,0,1172,1116,8,990,118,56,56,1.7,0.0,0.0,4.8,974486.94140625,4380.40736580817
50327,11367,11367,36081077903,263016,0,Census Tract 779.03,New York,Queens County,1545,2553,1739,1581,0,1491,54,36,158,134,0,134,0,24,814,746,0,634,112,68,128,5.0,2.3,15.2,8.4,458330.8828125,2858.2418397639503
50328,11366,11366,36081077904,385726,0,Census Tract 779.04,New York,Queens County,2347,4413,2683,2515,0,2165,182,168,168,168,0,153,15,0,1730,1472,0,1364,108,258,426,9.7,6.7,0.0,14.9,672196.5390625,3365.78640822263
50328,11367,11367,36081077904,385726,0,Census Tract 779.04,New York,Queens County,2347,4413,2683,2515,0,2165,182,168,168,168,0,153,15,0,1730,1472,0,1364,108,258,426,9.7,6.7,0.0,14.9,672196.5390625,3365.78640822263
50329,11367,11367,36081077905,275241,0,Census Tract 779.05,New York,Queens County,1266,2119,1430,1306,0,1252,14,40,124,124,0,124,0,0,689,598,22,551,25,91,131,6.2,3.1,0.0,13.2,479610.3984375,3373.81397395862
50329,11432,11432,36081077905,275241,0,Census Tract 779.05,New York,Queens County,1266,2119,1430,1306,0,1252,14,40,124,124,0,124,0,0,689,598,22,551,25,91,131,6.2,3.1,0.0,13.2,479610.3984375,3373.81397395862
50329,11435,11435,36081077905,275241,0,Census Tract 779.05,New York,Queens County,1266,2119,1430,1306,0,1252,14,40,124,124,0,124,0,0,689,598,22,551,25,91,131,6.2,3.1,0.0,13.2,479610.3984375,3373.81397395862
50330,11367,11367,36081077906,289075,0,Census Tract 779.06,New York,Queens County,1440,2824,1596,1511,0,1384,56,71,85,85,0,66,19,0,1228,1080,9,928,143,148,219,7.8,4.7,0.0,12.1,503898.2890625,3094.68075371231
50331,11367,11367,36081077907,216834,0,Census Tract 779.07,New York,Queens County,1144,1944,1246,1209,0,1087,57,65,37,37,0,37,0,0,698,543,0,536,7,155,220,11.3,5.4,0.0,22.2,377918.765625,2495.8061715911103
50332,11367,11367,36081077908,200497,0,Census Tract 779.08,New York,Queens County,1583,2841,1814,1614,0,1537,46,31,200,157,0,157,0,43,1027,997,0,962,35,30,104,3.7,1.9,21.5,2.9,349450.171875,2445.70013071844
50333,11436,11436,36081078800,192534,0,Census Tract 788,New York,Queens County,1049,1657,1204,1049,0,1017,32,0,155,155,0,155,0,0,453,401,0,362,39,52,52,3.1,0.0,0.0,11.5,335021.78515625,2673.0882280175697
50334,11436,11436,36081079000,260592,0,Census Tract 790,New York,Queens County,1397,2256,1538,1410,0,1284,113,13,128,128,0,97,31,0,718,684,0,608,76,34,47,2.1,0.9,0.0,4.7,453476.1875,3082.20649806734
50335,11436,11436,36081079200,363822,0,Census Tract 792,New York,Queens County,1167,1842,1280,1167,0,1067,100,0,113,113,0,82,31,0,562,538,0,454,84,24,24,1.3,0.0,0.0,4.3,633044.1640625,3312.1296335605102
50336,11367,11367,36081079300,870160,0,Census Tract 793,New York,Queens County,0,0,0,0,0,0,0,0,0,0,0,0,0,0,0,0,0,0,0,0,0,,,,,1517119.76171875,6323.193227101279
50337,11355,11355,36081079701,111310,0,Census Tract 797.01,New York,Queens County,2510,5632,2645,2593,0,2434,76,83,52,52,0,52,0,0,2987,2351,0,2149,202,636,719,12.8,3.2,0.0,21.3,194166.42578125,2008.7390406630602
50338,11355,11355,36081079702,285448,0,Census Tract 797.02,New York,Queens County,1747,4103,2302,2234,0,1634,113,487,68,46,0,46,0,22,1801,1358,0,1275,83,443,952,23.2,21.8,32.4,24.6,497902.37109375,3396.83748535858
50339,11355,11355,36081079900,287107,0,Census Tract 799,New York,Queens County,1128,2405,1351,1204,0,1090,38,76,147,147,0,147,0,0,1054,788,0,686,102,266,342,14.2,6.3,0.0,25.2,500730.890625,3146.82051324194
50340,11355,11355,36081080301,315274,0,Census Tract 803.01,New York,Queens County,1487,3175,1775,1705,0,1288,199,218,70,70,0,70,0,0,1400,1196,9,1033,154,204,422,13.3,12.8,0.0,14.6,549814.01171875,4272.565803814389
50341,11367,11367,36081080302,438822,0,Census Tract 803.02,New York,Queens County,1548,2864,1689,1583,0,1454,94,35,106,106,0,106,0,0,1175,1037,0,879,158,138,173,6.0,2.2,0.0,11.7,765174.4609375,5942.23766785699
50342,11367,11367,36081080900,1004959,0,Census Tract 809,New York,Queens County,3196,5735,3495,3449,0,3083,113,253,46,46,15,31,0,0,2240,2057,0,1974,83,183,436,7.6,7.3,0.0,8.2,1752007.421875,6608.299096441569
50343,11420,11420,36081081400,369558,0,Census Tract 814,New York,Queens County,1715,2922,1835,1723,0,1637,78,8,112,112,0,112,0,0,1087,1022,0,966,56,65,73,2.5,0.5,0.0,6.0,643060.6640625,3428.7909737287
50344,11420,11420,36081081800,374600,0,Census Tract 818,New York,Queens County,1878,3581,2111,1909,0,1815,63,31,202,202,0,202,0,0,1470,1400,0,1207,193,70,101,2.8,1.6,0.0,4.8,651829.61328125,3961.1634829725203
50345,11355,11355,36081083700,780782,0,Census Tract 837,New York,Queens County,2356,4535,2766,2668,0,2338,18,312,98,98,0,98,0,0,1769,1575,0,1495,80,194,506,11.2,11.7,0.0,11.0,1361628.234375,5580.61689846634
50345,11367,11367,36081083700,780782,0,Census Tract 837,New York,Queens County,2356,4535,2766,2668,0,2338,18,312,98,98,0,98,0,0,1769,1575,0,1495,80,194,506,11.2,11.7,0.0,11.0,1361628.234375,5580.61689846634
50346,11420,11420,36081083800,495382,0,Census Tract 838,New York,Queens County,3007,4776,3179,3065,0,2991,16,58,114,114,0,114,0,0,1597,1424,0,1358,66,173,231,4.8,1.9,0.0,10.8,861996.08984375,4240.32998072331
50347,11420,11420,36081084000,568482,0,Census Tract 840,New York,Queens County,3151,5268,3514,3227,0,2969,182,76,287,287,0,248,39,0,1754,1625,0,1476,149,129,205,3.9,2.4,0.0,7.4,989301.8359375,4600.19568633546
50348,11355,11355,36081084500,188676,0,Census Tract 845,New York,Queens County,2209,4531,2489,2463,0,2133,76,254,26,26,0,26,0,0,2042,1187,0,1032,155,855,1109,24.5,10.3,0.0,41.9,329089.203125,2753.47721614323
50349,11420,11420,36081084601,333236,0,Census Tract 846.01,New York,Queens County,1473,2509,1588,1493,0,1377,96,20,95,95,0,95,0,0,921,855,0,794,61,66,86,3.4,1.3,0.0,7.2,579801.50390625,4059.55985884526
50350,11420,11420,36081084602,717562,0,Census Tract 846.02,New York,Queens County,381,573,414,384,0,373,8,3,30,30,0,30,0,0,159,159,0,159,0,0,3,0.5,0.8,0.0,0.0,1248411.42578125,7652.3802557923
50350,11430,11434,36081084602,717562,0,Census Tract 846.02,New York,Queens County,381,573,414,384,0,373,8,3,30,30,0,30,0,0,159,159,0,159,0,0,3,0.5,0.8,0.0,0.0,1248411.42578125,7652.3802557923
50351,11355,11355,36081084900,303514,0,Census Tract 849,New York,Queens County,2679,5850,3531,3309,0,2085,594,630,222,163,0,140,23,59,2319,1831,0,1528,303,488,1177,20.1,19.0,26.6,21.0,529465.8125,3383.82181045206
50352,11354,11354,36081085300,195226,0,Census Tract 853,New York,Queens County,2023,4480,2408,2254,0,1943,80,231,154,134,0,134,0,20,2072,1648,0,1463,185,424,675,15.1,10.2,13.0,20.5,340585.7109375,3193.00075871184
50352,11355,11355,36081085300,195226,0,Census Tract 853,New York,Queens County,2023,4480,2408,2254,0,1943,80,231,154,134,0,134,0,20,2072,1648,0,1463,185,424,675,15.1,10.2,13.0,20.5,340585.7109375,3193.00075871184
50353,11354,11354,36081085500,130506,0,Census Tract 855,New York,Queens County,2630,5745,3422,3292,0,2335,295,662,130,130,0,130,0,0,2323,1651,0,1537,114,672,1334,23.2,20.1,0.0,28.9,227694.46484375,1923.8544059913897
50353,11355,11355,36081085500,130506,0,Census Tract 855,New York,Queens County,2630,5745,3422,3292,0,2335,295,662,130,130,0,130,0,0,2323,1651,0,1537,114,672,1334,23.2,20.1,0.0,28.9,227694.46484375,1923.8544059913897
50354,11355,11355,36081085700,132521,0,Census Tract 857,New York,Queens County,2180,4336,2664,2576,0,2102,78,396,88,22,0,22,0,66,1672,1268,0,1181,87,404,866,20.0,15.4,75.0,24.2,231190.57421875,2147.51438485895
50355,11355,11355,36081085900,146219,0,Census Tract 859,New York,Queens County,2540,4578,2800,2698,0,2191,349,158,102,90,0,90,0,12,1778,1711,0,1536,175,67,237,5.2,5.9,11.8,3.8,255073.79296875,2453.95014885776
50356,11355,11355,36081086100,148788,0,Census Tract 861,New York,Queens County,953,1824,1026,1009,0,926,27,56,17,12,0,12,0,5,798,589,0,559,30,209,270,14.8,5.6,29.4,26.2,259567.94921875,2607.9444821247503
50357,11354,11354,36081086300,144154,0,Census Tract 863,New York,Queens County,2660,5706,3245,3197,0,2466,194,537,48,48,0,28,20,0,2461,2082,0,1899,183,379,916,16.1,16.8,0.0,15.4,251518.40625,2045.01104527524
50357,11355,11355,36081086300,144154,0,Census Tract 863,New York,Queens County,2660,5706,3245,3197,0,2466,194,537,48,48,0,28,20,0,2461,2082,0,1899,183,379,916,16.1,16.8,0.0,15.4,251518.40625,2045.01104527524
50358,11417,11417,36081086400,1120710,0,Census Tract 864,New York,Queens County,1367,2211,1456,1385,0,1319,48,18,71,62,0,59,3,9,755,671,0,634,37,84,111,5.0,1.3,12.7,11.1,1950281.30078125,6022.69328246234
50358,11420,11420,36081086400,1120710,0,Census Tract 864,New York,Queens County,1367,2211,1456,1385,0,1319,48,18,71,62,0,59,3,9,755,671,0,634,37,84,111,5.0,1.3,12.7,11.1,1950281.30078125,6022.69328246234
50359,11354,11354,36081086500,158252,0,Census Tract 865,New York,Queens County,1917,4144,2472,2336,0,1658,259,419,136,136,0,50,86,0,1672,1018,0,887,131,654,1073,25.9,17.9,0.0,39.1,276127.05859375,2085.15979748632
50360,11354,11354,36081086900,595378,18201,Census Tract 869,New York,Queens County,853,1660,915,882,0,809,44,29,33,33,0,33,0,0,745,633,0,589,44,112,141,8.5,3.3,0.0,15.0,1046193.625,4834.329322490539
50361,11354,11354,36081087100,412384,27328,Census Tract 871,New York,Queens County,1051,2154,1195,1162,0,975,76,111,33,27,0,27,0,6,959,642,0,554,88,317,434,20.1,9.6,18.2,33.1,732987.453125,4758.17341415129
50361,11355,11355,36081087100,412384,27328,Census Tract 871,New York,Queens County,1051,2154,1195,1162,0,975,76,111,33,27,0,27,0,6,959,642,0,554,88,317,434,20.1,9.6,18.2,33.1,732987.453125,4758.17341415129
50362,11414,11414,36081088400,1557916,621618,Census Tract 884,New York,Queens County,3569,6857,3898,3664,0,3394,175,95,234,200,0,186,14,34,2959,2484,0,2335,149,475,604,8.8,2.6,14.5,16.1,2650755.96484375,13756.134837411299
50363,11351,11357,36081088901,657467,0,Census Tract 889.01,New York,Queens County,4769,8477,5300,5204,0,4523,246,435,96,96,0,96,0,0,3177,2660,0,2597,63,517,952,11.2,8.4,0.0,16.3,1147535.86328125,6042.42209958707
50363,11354,11354,36081088901,657467,0,Census Tract 889.01,New York,Queens County,4769,8477,5300,5204,0,4523,246,435,96,96,0,96,0,0,3177,2660,0,2597,63,517,952,11.2,8.4,0.0,16.3,1147535.86328125,6042.42209958707
50363,11357,11357,36081088901,657467,0,Census Tract 889.01,New York,Queens County,4769,8477,5300,5204,0,4523,246,435,96,96,0,96,0,0,3177,2660,0,2597,63,517,952,11.2,8.4,0.0,16.3,1147535.86328125,6042.42209958707
50364,11414,11414,36081089200,2874373,505629,Census Tract 892,New York,Queens County,3501,6646,3609,3561,0,3491,10,60,48,48,0,23,25,0,3037,2673,0,2540,133,364,424,6.4,1.7,0.0,12.0,4938548.94140625,12033.484781223999
50365,11354,11354,36081090700,2022039,332865,Census Tract 907,New York,Queens County,542,1048,604,585,0,542,0,43,19,19,0,19,0,0,444,295,0,295,0,149,192,18.3,7.4,0.0,33.6,3513688.421875,8965.738380643821
50365,11356,11356,36081090700,2022039,332865,Census Tract 907,New York,Queens County,542,1048,604,585,0,542,0,43,19,19,0,19,0,0,444,295,0,295,0,149,192,18.3,7.4,0.0,33.6,3513688.421875,8965.738380643821
50366,11697,11697,36081091601,4374026,4924631,Census Tract 916.01,New York,Queens County,1489,2807,1584,1508,9,1472,8,19,76,76,0,76,0,0,1223,1064,9,985,70,159,178,6.3,1.3,0.0,13.0,5668436.69140625,15524.925648726101
50367,11697,11697,36081091602,1277598,1124549,Census Tract 916.02,New York,Queens County,0,0,0,0,0,0,0,0,0,0,0,0,0,0,0,0,0,0,0,0,0,,,,,2265291.140625,6665.64309150168
50368,11694,11694,36081091800,1126858,2293626,Census Tract 918,New York,Queens County,0,12,0,0,0,0,0,0,0,0,0,0,0,0,12,12,0,12,0,0,0,0.0,,,0.0,2146776.75390625,7711.17999934386
50368,11697,11697,36081091800,1126858,2293626,Census Tract 918,New York,Queens County,0,12,0,0,0,0,0,0,0,0,0,0,0,0,12,12,0,12,0,0,0,0.0,,,0.0,2146776.75390625,7711.17999934386
50369,11354,11354,36081091900,450774,327380,Census Tract 919,New York,Queens County,2334,4207,2696,2566,0,2259,75,232,130,130,0,114,16,0,1511,1289,0,1246,43,222,454,10.8,9.0,0.0,14.7,740696.6171875,5297.316891897921
50369,11356,11356,36081091900,450774,327380,Census Tract 919,New York,Queens County,2334,4207,2696,2566,0,2259,75,232,130,130,0,114,16,0,1511,1289,0,1246,43,222,454,10.8,9.0,0.0,14.7,740696.6171875,5297.316891897921
50370,11694,11694,36081092200,633290,700664,Census Tract 922,New York,Queens County,988,1609,1012,988,0,945,43,0,24,24,0,24,0,0,597,546,0,483,63,51,51,3.2,0.0,0.0,8.5,1156819.34765625,5460.0806662359
50371,11356,11356,36081092500,312425,0,Census Tract 925,New York,Queens County,1283,3187,1656,1513,0,1221,62,230,143,133,0,114,19,10,1531,1255,0,1219,36,276,516,16.2,15.2,7.0,18.0,545456.640625,3107.12758404163
50372,11694,11694,36081092800,762718,897590,Census Tract 928,New York,Queens County,1697,2858,1750,1707,0,1659,38,10,43,43,0,43,0,0,1108,1060,0,1013,47,48,58,2.0,0.6,0.0,4.3,1327977.0234375,5272.87148530159
50373,11356,11356,36081092900,956919,2446820,Census Tract 929,New York,Queens County,2902,4999,3324,3219,0,2704,198,317,105,105,0,105,0,0,1675,1345,31,1212,102,330,647,12.9,9.8,0.0,19.7,1610512.8203125,7790.95480478855
50374,11694,11694,36081093401,542009,554670,Census Tract 934.01,New York,Queens County,1565,2729,1672,1595,22,1495,48,30,77,69,23,46,0,8,1057,938,0,868,70,119,157,5.8,1.9,10.4,11.3,957888.6640625,5686.090997569879
50375,11694,11694,36081093402,394743,460266,Census Tract 934.02,New York,Queens County,2245,3646,2466,2265,0,1981,264,20,201,201,0,118,83,0,1180,1018,0,995,23,162,182,5.0,0.9,0.0,13.7,648475.609375,3654.27811557846
50376,11694,11694,36081093800,809668,1300951,Census Tract 938,New York,Queens County,1446,3368,1746,1666,0,1245,201,220,80,60,0,60,0,20,1622,1164,17,1059,88,458,698,20.7,13.2,25.0,28.2,1442796.9375,5308.11389633968
50377,11356,11356,36081093900,656191,881592,Census Tract 939,New York,Queens County,2283,4032,2535,2469,0,2236,47,186,66,43,0,43,0,23,1497,1188,0,1146,42,309,518,12.8,7.5,34.8,20.6,1129961.69140625,5678.76371774671
50378,11693,11693,36081094201,347514,199843,Census Tract 942.01,New York,Queens County,1502,2536,1732,1578,0,1424,78,76,154,154,0,119,35,0,804,786,0,756,30,18,94,3.7,4.8,0.0,2.2,614750.125,3361.4690852945696
50378,11694,11694,36081094201,347514,199843,Census Tract 942.01,New York,Queens County,1502,2536,1732,1578,0,1424,78,76,154,154,0,119,35,0,804,786,0,756,30,18,94,3.7,4.8,0.0,2.2,614750.125,3361.4690852945696
50379,11692,11692,36081094202,713772,458004,Census Tract 942.02,New York,Queens County,1747,3329,2002,1813,0,1493,254,66,189,174,0,157,17,15,1327,1117,0,1034,83,210,291,8.7,3.6,7.9,15.8,1335327.71875,7576.37435555372
50379,11693,11693,36081094202,713772,458004,Census Tract 942.02,New York,Queens County,1747,3329,2002,1813,0,1493,254,66,189,174,0,157,17,15,1327,1117,0,1034,83,210,291,8.7,3.6,7.9,15.8,1335327.71875,7576.37435555372
50380,11692,11692,36081094203,509892,1050429,Census Tract 942.03,New York,Queens County,3531,5609,3894,3780,0,3166,365,249,114,114,0,114,0,0,1715,1438,0,1168,270,277,526,9.4,6.6,0.0,16.2,843829.203125,5727.796595711121
50380,11693,11693,36081094203,509892,1050429,Census Tract 942.03,New York,Queens County,3531,5609,3894,3780,0,3166,365,249,114,114,0,114,0,0,1715,1438,0,1168,270,277,526,9.4,6.6,0.0,16.2,843829.203125,5727.796595711121
50381,11356,11356,36081094500,1518736,872808,Census Tract 945,New York,Queens County,1540,2922,1665,1599,4,1423,113,59,66,66,4,62,0,0,1257,1107,6,994,107,150,209,7.2,3.7,0.0,11.9,2656353.76953125,11313.8064588293
50381,11357,11357,36081094500,1518736,872808,Census Tract 945,New York,Queens County,1540,2922,1665,1599,4,1423,113,59,66,66,4,62,0,0,1257,1107,6,994,107,150,209,7.2,3.7,0.0,11.9,2656353.76953125,11313.8064588293
50382,11356,11356,36081094700,272641,0,Census Tract 947,New York,Queens County,815,1833,968,938,0,789,26,123,30,30,0,30,0,0,865,695,0,695,0,170,293,16.0,13.1,0.0,19.7,476046.14453125,3513.69098217213
50383,11692,11692,36081095400,808825,559625,Census Tract 954,New York,Queens County,2136,4053,2492,2147,0,1854,282,11,345,293,0,255,38,52,1561,1380,16,1237,127,181,244,6.0,0.5,15.1,11.6,1407373.3203125,6270.481826946229
50384,11692,11692,36081096400,862704,586619,Census Tract 964,New York,Queens County,2369,4122,2699,2452,0,2206,163,83,247,247,0,247,0,0,1423,1380,0,1272,108,43,126,3.1,3.4,0.0,3.0,1547380.88671875,6991.78882292531
50385,11691,11691,36081097202,576641,1132095,Census Tract 972.02,New York,Queens County,947,2051,1136,1018,0,873,74,71,118,118,0,95,23,0,915,762,0,676,86,153,224,10.9,7.0,0.0,16.7,904514.46484375,5438.18935646592
50385,11692,11692,36081097202,576641,1132095,Census Tract 972.02,New York,Queens County,947,2051,1136,1018,0,873,74,71,118,118,0,95,23,0,915,762,0,676,86,153,224,10.9,7.0,0.0,16.7,904514.46484375,5438.18935646592
50386,11691,11691,36081097203,1314888,1020625,Census Tract 972.03,New York,Queens County,2062,5313,2745,2170,0,1758,304,108,575,549,0,438,111,26,2568,2350,0,1773,577,218,352,6.6,5.0,4.5,8.5,2633971.52734375,10828.912886075
50386,11692,11692,36081097203,1314888,1020625,Census Tract 972.03,New York,Queens County,2062,5313,2745,2170,0,1758,304,108,575,549,0,438,111,26,2568,2350,0,1773,577,218,352,6.6,5.0,4.5,8.5,2633971.52734375,10828.912886075
50387,11691,11691,36081097204,391826,0,Census Tract 972.04,New York,Queens County,1044,2183,1344,1138,0,954,90,94,206,134,0,134,0,72,839,655,0,570,85,184,350,16.0,8.3,35.0,21.9,680260.671875,4288.35550031188
50387,11692,11692,36081097204,391826,0,Census Tract 972.04,New York,Queens County,1044,2183,1344,1138,0,954,90,94,206,134,0,134,0,72,839,655,0,570,85,184,350,16.0,8.3,35.0,21.9,680260.671875,4288.35550031188
50388,11357,11357,36081097300,528721,191606,Census Tract 973,New York,Queens County,767,1488,862,782,0,752,15,15,80,80,0,80,0,0,626,482,6,447,29,144,159,10.7,1.9,0.0,23.0,920128.87890625,4744.03196218681
50389,11357,11357,36081098100,650601,922899,Census Tract 981,New York,Queens County,923,1872,1004,965,0,915,8,42,39,39,0,39,0,0,868,749,13,714,22,119,161,8.6,4.4,0.0,13.7,1124276.9609375,6888.23637766468
50390,11357,11357,36081098700,667301,731613,Census Tract 987,New York,Queens County,1108,1875,1175,1124,0,1094,14,16,51,51,0,46,5,0,700,582,0,582,0,118,134,7.1,1.4,0.0,16.9,1148754.4609375,6716.8958362738
50391,11357,11357,36081099100,1081249,432743,Census Tract 991,New York,Queens County,3464,5854,3633,3490,16,3417,31,26,143,143,0,143,0,0,2221,1941,15,1859,67,280,306,5.2,0.7,0.0,12.6,1914678.80078125,6572.96257636854
50392,11691,11691,36081099200,581564,324488,Census Tract 992,New York,Queens County,1350,2757,1682,1405,51,1234,65,55,277,262,0,230,32,15,1075,917,0,807,110,158,228,8.3,3.9,5.4,14.7,1029287.78125,6205.96914923188
50393,11357,11357,36081099701,978866,0,Census Tract 997.01,New York,Queens County,1515,2617,1636,1515,15,1398,102,0,121,121,0,100,21,0,981,831,7,789,35,150,150,5.7,0.0,0.0,15.3,1708920.05078125,5478.95836185005
50393,11360,11360,36081099701,978866,0,Census Tract 997.01,New York,Queens County,1515,2617,1636,1515,15,1398,102,0,121,121,0,100,21,0,981,831,7,789,35,150,150,5.7,0.0,0.0,15.3,1708920.05078125,5478.95836185005
50394,11360,11360,36081099703,576606,0,Census Tract 997.03,New York,Queens County,1730,3116,1787,1730,0,1720,10,0,57,57,0,57,0,0,1329,1188,0,1102,86,141,141,4.5,0.0,0.0,10.6,1005092.953125,5929.395697567939
50395,11360,11360,36081099704,675915,0,Census Tract 997.04,New York,Queens County,3084,6161,3245,3084,0,3019,65,0,161,161,0,161,0,0,2916,2510,14,2381,115,406,406,6.6,0.0,0.0,13.9,1180046.31640625,5061.08056623763
50396,11360,11360,36081099705,440081,4538936,Census Tract 997.05,New York,Queens County,1440,2280,1494,1471,0,1223,217,31,23,23,0,23,0,0,786,628,0,526,102,158,189,8.3,2.1,0.0,20.1,850955.8203125,11394.398553073
50397,11691,11691,36081099801,456707,0,Census Tract 998.01,New York,Queens County,4046,6475,4518,4288,0,4005,41,242,230,230,0,230,0,0,1957,1730,0,1672,58,227,469,7.2,5.6,0.0,11.6,792998.71484375,3798.5421531927204
50398,11691,11691,36081099802,434629,689393,Census Tract 998.02,New York,Queens County,1917,4757,2485,2158,0,1673,244,241,327,327,0,327,0,0,2272,1516,20,1021,475,756,997,21.0,11.2,0.0,33.3,831498.2890625,3870.1035144193297
50399,11359,11360,36081099900,648383,0,Census Tract 999,New York,Queens County,0,0,0,0,0,0,0,0,0,0,0,0,0,0,0,0,0,0,0,0,0,,,,,1101529.453125,5348.49876549791
50400,11691,11691,36081100801,644973,339805,Census Tract 1008.01,New York,Queens County,946,1635,1074,946,0,946,0,0,128,128,0,128,0,0,561,491,0,480,11,70,70,4.3,0.0,0.0,12.5,1130511.48828125,5674.057619231371
50401,11691,11691,36081100802,1038703,144963,Census Tract 1008.02,New York,Queens County,3806,6426,4402,3893,0,3371,435,87,509,491,0,307,184,18,2024,1867,0,1776,91,157,262,4.1,2.2,3.5,7.8,1751838.09765625,6568.60713569168
50402,11691,11691,36081101001,804855,210562,Census Tract 1010.01,New York,Queens County,3748,7031,4311,4016,0,3122,626,268,295,295,0,295,0,0,2720,1708,0,1453,255,1012,1280,18.2,6.7,0.0,37.2,1377674.25390625,5435.13077381522
50403,11691,11691,36081101002,556508,113552,Census Tract 1010.02,New York,Queens County,1216,3010,1411,1358,0,1064,152,142,53,53,0,23,30,0,1599,1162,25,998,139,437,579,19.2,10.5,0.0,27.3,977838.296875,4467.63555452638
50404,11357,11357,36081101700,987636,0,Census Tract 1017,New York,Queens County,2557,4909,2709,2584,0,2455,102,27,125,125,0,125,0,0,2200,1905,0,1769,136,295,322,6.6,1.0,0.0,13.4,1724164.86328125,5631.81336497566
50404,11358,11358,36081101700,987636,0,Census Tract 1017,New York,Queens County,2557,4909,2709,2584,0,2455,102,27,125,125,0,125,0,0,2200,1905,0,1769,136,295,322,6.6,1.0,0.0,13.4,1724164.86328125,5631.81336497566
50405,11357,11357,36081102900,490509,0,Census Tract 1029,New York,Queens County,1540,3020,1605,1560,0,1531,9,20,45,45,0,45,0,0,1415,1116,0,1116,0,299,319,10.6,1.3,0.0,21.1,856411.23828125,4309.93612696944
50406,11691,11691,36081103201,400183,28173,Census Tract 1032.01,New York,Queens County,2335,4504,2765,2551,0,1970,365,216,214,210,0,124,86,4,1739,1515,0,1351,164,224,444,9.9,8.5,1.9,12.9,705357.23828125,4335.7929804552205
50407,11691,11691,36081103202,712534,0,Census Tract 1032.02,New York,Queens County,2979,4922,3466,3205,0,2817,162,226,261,245,0,229,16,16,1456,1346,0,1202,144,110,352,7.2,7.1,6.1,7.6,1237506.52734375,4660.774251793599
50408,11357,11357,36081103300,606048,0,Census Tract 1033,New York,Queens County,2075,3572,2206,2115,0,2065,10,40,91,91,0,91,0,0,1366,1177,14,1060,103,189,229,6.4,1.9,0.0,13.8,1057989.80078125,4670.94298711714
50409,11357,11357,36081103900,878035,0,Census Tract 1039,New York,Queens County,3093,5330,3516,3189,0,2899,194,96,327,252,0,233,19,75,1814,1650,0,1448,202,164,335,6.3,3.0,22.9,9.0,1533022.1875,5520.292682899829
50410,11354,11354,36081104700,841801,0,Census Tract 1047,New York,Queens County,2585,5453,2896,2701,0,2476,109,116,195,195,0,163,32,0,2557,2133,0,1938,195,424,540,9.9,4.3,0.0,16.6,1469361.890625,5298.61239521204
50410,11357,11357,36081104700,841801,0,Census Tract 1047,New York,Queens County,2585,5453,2896,2701,0,2476,109,116,195,195,0,163,32,0,2557,2133,0,1938,195,424,540,9.9,4.3,0.0,16.6,1469361.890625,5298.61239521204
50411,11354,11354,36081105900,649579,0,Census Tract 1059,New York,Queens County,1617,3116,1680,1627,10,1564,43,10,53,53,0,53,0,0,1436,1198,33,1057,108,238,248,8.0,0.6,0.0,16.6,1133800.19921875,4928.095410130711
50411,11357,11357,36081105900,649579,0,Census Tract 1059,New York,Queens County,1617,3116,1680,1627,10,1564,43,10,53,53,0,53,0,0,1436,1198,33,1057,108,238,248,8.0,0.6,0.0,16.6,1133800.19921875,4928.095410130711
50411,11358,11358,36081105900,649579,0,Census Tract 1059,New York,Queens County,1617,3116,1680,1627,10,1564,43,10,53,53,0,53,0,0,1436,1198,33,1057,108,238,248,8.0,0.6,0.0,16.6,1133800.19921875,4928.095410130711
50412,11693,11693,36081107201,1385932,0,Census Tract 1072.01,New York,Queens County,1071,1676,1108,1071,0,986,85,0,37,37,0,37,0,0,568,511,0,439,72,57,57,3.4,0.0,0.0,10.0,2152591.7265625,12736.0295854248
50414,11358,11358,36081108500,444815,0,Census Tract 1085,New York,Queens County,952,1922,1067,1050,0,938,14,98,17,17,0,17,0,0,855,773,0,755,18,82,180,9.4,9.3,0.0,9.6,776365.171875,3745.5555962595
50414,11360,11360,36081108500,444815,0,Census Tract 1085,New York,Queens County,952,1922,1067,1050,0,938,14,98,17,17,0,17,0,0,855,773,0,755,18,82,180,9.4,9.3,0.0,9.6,776365.171875,3745.5555962595
50415,11360,11360,36081109300,1069850,458982,Census Tract 1093,New York,Queens County,1372,2543,1473,1390,0,1325,47,18,83,83,0,83,0,0,1070,960,0,886,74,110,128,5.0,1.3,0.0,10.3,1931653.41015625,8289.93620657126
50415,11361,11361,36081109300,1069850,458982,Census Tract 1093,New York,Queens County,1372,2543,1473,1390,0,1325,47,18,83,83,0,83,0,0,1070,960,0,886,74,110,128,5.0,1.3,0.0,10.3,1931653.41015625,8289.93620657126
50416,11361,11361,36081109700,445149,0,Census Tract 1097,New York,Queens County,913,1451,936,913,7,906,0,0,23,23,0,23,0,0,515,479,6,446,27,36,36,2.5,0.0,0.0,7.0,776902.3359375,4566.32112494549
50417,11358,11358,36081109900,378701,0,Census Tract 1099,New York,Queens County,1421,2625,1494,1450,0,1303,118,29,44,44,0,44,0,0,1131,929,0,852,77,202,231,8.8,2.0,0.0,17.9,660879.96484375,3329.91307723074
50417,11361,11361,36081109900,378701,0,Census Tract 1099,New York,Queens County,1421,2625,1494,1450,0,1303,118,29,44,44,0,44,0,0,1131,929,0,852,77,202,231,8.8,2.0,0.0,17.9,660879.96484375,3329.91307723074
50418,11361,11361,36081111300,730305,105941,Census Tract 1113,New York,Queens County,1090,2024,1202,1127,0,1052,38,37,75,75,0,66,9,0,822,758,0,699,59,64,101,5.0,3.3,0.0,7.8,1266818.05078125,5313.3184582712
50419,11361,11361,36081112300,279273,0,Census Tract 1123,New York,Queens County,1038,1577,1123,1057,0,1022,16,19,66,61,0,61,0,5,454,403,0,377,26,51,75,4.8,1.8,7.6,11.2,487345.54296875,3141.9965437394603
50420,11361,11361,36081112900,354968,0,Census Tract 1129,New York,Queens County,1069,1673,1094,1069,0,1049,20,0,25,25,0,25,0,0,579,500,0,474,26,79,79,4.7,0.0,0.0,13.6,619422.6875,3655.4012388362
50421,11358,11358,36081113300,253829,0,Census Tract 1133,New York,Queens County,846,1445,879,852,5,835,6,6,27,27,0,27,0,0,566,493,0,493,0,73,79,5.5,0.7,0.0,12.9,442915.15234375,2786.56269635122
50421,11361,11361,36081113300,253829,0,Census Tract 1133,New York,Queens County,846,1445,879,852,5,835,6,6,27,27,0,27,0,0,566,493,0,493,0,73,79,5.5,0.7,0.0,12.9,442915.15234375,2786.56269635122
50422,11358,11358,36081113900,383381,0,Census Tract 1139,New York,Queens County,1474,2750,1640,1548,0,1454,20,74,92,92,0,92,0,0,1110,899,0,796,103,211,285,10.4,4.8,0.0,19.0,668976.11328125,4074.6127825753297
50423,11358,11358,36081114100,448090,0,Census Tract 1141,New York,Queens County,1165,2123,1246,1183,0,1103,62,18,63,63,0,56,7,0,877,779,0,711,68,98,116,5.5,1.5,0.0,11.2,782002.81640625,3995.22378795887
50424,11358,11358,36081114700,308438,0,Census Tract 1147,New York,Queens County,813,1443,896,813,0,771,42,0,83,83,0,83,0,0,547,497,18,438,41,50,50,3.5,0.0,0.0,9.1,538270.4296875,3057.53876892766
50425,11354,11354,36081115100,282637,13939,Census Tract 1151,New York,Queens County,452,941,483,483,0,448,4,31,0,0,0,0,0,0,458,359,0,356,3,99,130,13.8,6.4,,21.6,517574.8671875,2903.1551978801
50425,11358,11358,36081115100,282637,13939,Census Tract 1151,New York,Queens County,452,941,483,483,0,448,4,31,0,0,0,0,0,0,458,359,0,356,3,99,130,13.8,6.4,,21.6,517574.8671875,2903.1551978801
50426,11354,11354,36081115500,187009,0,Census Tract 1155,New York,Queens County,909,1795,1040,994,0,867,42,85,46,41,0,41,0,5,755,640,0,602,38,115,205,11.4,8.6,10.9,15.2,326354.8359375,3009.84687634498
50427,11354,11354,36081115700,314622,0,Census Tract 1157,New York,Queens County,1262,2894,1458,1410,0,1207,55,148,48,48,0,48,0,0,1436,1195,19,1070,106,241,389,13.4,10.5,0.0,16.8,549053.02734375,3217.5544133570597
50428,11354,11354,36081115900,308992,0,Census Tract 1159,New York,Queens County,1741,3462,2055,1933,5,1665,71,192,122,94,0,66,28,28,1407,1067,5,997,65,340,560,16.2,9.9,23.0,24.2,539249.34765625,2952.83932281753
50429,11354,11354,36081116100,175693,0,Census Tract 1161,New York,Queens County,1445,3520,1734,1610,0,1318,127,165,124,116,0,72,44,8,1786,1387,0,1050,337,399,572,16.3,10.2,6.5,22.3,306597.69140625,2510.02748900917
50430,11354,11354,36081116300,251471,0,Census Tract 1163,New York,Queens County,3480,7414,4404,4259,0,3280,200,779,145,109,0,96,13,36,3010,2381,0,2069,312,629,1444,19.5,18.3,24.8,20.9,438796.71875,3421.6835998652
50430,11355,11355,36081116300,251471,0,Census Tract 1163,New York,Queens County,3480,7414,4404,4259,0,3280,200,779,145,109,0,96,13,36,3010,2381,0,2069,312,629,1444,19.5,18.3,24.8,20.9,438796.71875,3421.6835998652
50431,11354,11354,36081116700,166109,0,Census Tract 1167,New York,Queens County,665,1509,839,794,0,603,62,129,45,39,0,11,28,6,670,445,0,382,63,225,360,23.9,16.2,13.3,33.6,289831.51171875,2697.41232889637
50431,11355,11355,36081116700,166109,0,Census Tract 1167,New York,Queens County,665,1509,839,794,0,603,62,129,45,39,0,11,28,6,670,445,0,382,63,225,360,23.9,16.2,13.3,33.6,289831.51171875,2697.41232889637
50432,11354,11354,36081117100,397540,0,Census Tract 1171,New York,Queens County,1114,2114,1286,1243,0,982,132,129,43,43,0,43,0,0,828,726,0,617,109,102,231,10.9,10.4,0.0,12.3,693662.57421875,3999.0526060298603
50432,11358,11358,36081117100,397540,0,Census Tract 1171,New York,Queens County,1114,2114,1286,1243,0,982,132,129,43,43,0,43,0,0,828,726,0,617,109,102,231,10.9,10.4,0.0,12.3,693662.57421875,3999.0526060298603
50433,11358,11358,36081117500,562493,0,Census Tract 1175,New York,Queens County,2203,4044,2486,2367,0,2102,101,164,119,119,0,119,0,0,1558,1278,0,1215,63,280,444,11.0,6.9,0.0,18.0,981437.05078125,4435.88865005387
50434,11358,11358,36081118100,195225,0,Census Tract 1181,New York,Queens County,852,1409,917,878,0,826,26,26,39,39,0,39,0,0,492,442,0,397,45,50,76,5.4,3.0,0.0,10.2,340606.90625,2441.80697479438
50434,11361,11361,36081118100,195225,0,Census Tract 1181,New York,Queens County,852,1409,917,878,0,826,26,26,39,39,0,39,0,0,492,442,0,397,45,50,76,5.4,3.0,0.0,10.2,340606.90625,2441.80697479438
50435,11355,11355,36081118500,155079,0,Census Tract 1185,New York,Queens County,882,1782,1097,1038,0,831,51,156,59,59,0,59,0,0,685,566,0,490,76,119,275,15.4,15.0,0.0,17.4,270563.12109375,3260.9200280889195
50435,11358,11358,36081118500,155079,0,Census Tract 1185,New York,Queens County,882,1782,1097,1038,0,831,51,156,59,59,0,59,0,0,685,566,0,490,76,119,275,15.4,15.0,0.0,17.4,270563.12109375,3260.9200280889195
50436,11355,11355,36081118700,187235,0,Census Tract 1187,New York,Queens County,1104,2011,1232,1184,0,977,127,80,48,48,0,48,0,0,779,649,0,565,84,130,210,10.4,6.8,0.0,16.7,326668.59765625,2531.69920205392
50437,11355,11355,36081118900,202351,0,Census Tract 1189,New York,Queens County,990,1900,1075,1047,0,878,112,57,28,28,0,28,0,0,825,733,0,627,106,92,149,7.8,5.4,0.0,11.2,353008.015625,2416.65041073256
50438,11355,11355,36081119100,217684,0,Census Tract 1191,New York,Queens County,1212,2526,1443,1408,0,1167,45,196,35,35,0,35,0,0,1083,953,0,867,86,130,326,12.9,13.9,0.0,12.0,379758.921875,2933.70365169857
50438,11358,11358,36081119100,217684,0,Census Tract 1191,New York,Queens County,1212,2526,1443,1408,0,1167,45,196,35,35,0,35,0,0,1083,953,0,867,86,130,326,12.9,13.9,0.0,12.0,379758.921875,2933.70365169857
50439,11358,11358,36081119300,211094,0,Census Tract 1193,New York,Queens County,921,1671,1066,1012,0,884,37,91,54,54,0,54,0,0,605,560,0,525,35,45,136,8.1,9.0,0.0,7.4,368267.421875,2807.75661794401
50440,11358,11358,36081119500,189356,0,Census Tract 1195,New York,Queens County,561,1204,620,567,0,561,0,6,53,53,0,53,0,0,584,540,0,540,0,44,50,4.2,1.1,0.0,7.5,330324.46484375,2729.34482533758
50441,11355,11355,36081119900,184357,0,Census Tract 1199,New York,Queens County,672,1376,817,767,0,623,49,95,50,50,0,50,0,0,559,495,5,465,25,64,159,11.6,12.4,0.0,11.4,321590.421875,2855.1985284156203
50441,11358,11358,36081119900,184357,0,Census Tract 1199,New York,Queens County,672,1376,817,767,0,623,49,95,50,50,0,50,0,0,559,495,5,465,25,64,159,11.6,12.4,0.0,11.4,321590.421875,2855.1985284156203
50442,11355,11355,36081120100,162893,0,Census Tract 1201,New York,Queens County,663,1333,743,734,0,627,36,71,9,9,0,9,0,0,590,533,0,492,41,57,128,9.6,9.7,0.0,9.7,284145.28125,2619.06499607632
50443,11355,11355,36081120300,184012,0,Census Tract 1203,New York,Queens County,602,1377,688,638,0,596,6,36,50,50,0,42,8,0,689,618,0,605,13,71,107,7.8,5.6,0.0,10.3,320940.29296875,2613.93448551083
50444,11355,11355,36081120500,202234,0,Census Tract 1205,New York,Queens County,803,2330,977,937,0,753,50,134,40,27,0,19,8,13,1353,797,0,729,68,556,703,30.2,14.3,32.5,41.1,352748.359375,2441.97290615087
50445,11358,11358,36081120700,704083,0,Census Tract 1207,New York,Queens County,1383,2685,1456,1388,0,1337,46,5,68,68,0,68,0,0,1229,1122,0,1066,56,107,112,4.2,0.4,0.0,8.7,1228085.1796875,5581.43514367078
50445,11365,11365,36081120700,704083,0,Census Tract 1207,New York,Queens County,1383,2685,1456,1388,0,1337,46,5,68,68,0,68,0,0,1229,1122,0,1066,56,107,112,4.2,0.4,0.0,8.7,1228085.1796875,5581.43514367078
50446,11365,11365,36081121100,979719,46201,Census Tract 1211,New York,Queens County,0,0,0,0,0,0,0,0,0,0,0,0,0,0,0,0,0,0,0,0,0,,,,,1789159.55078125,6305.74010411645
50447,11355,11355,36081121500,631660,0,Census Tract 1215,New York,Queens County,2001,3604,2164,2066,0,1908,93,65,98,98,0,98,0,0,1440,1208,0,1087,121,232,297,8.2,3.1,0.0,16.1,1101429.3125,5201.468208088821
50447,11365,11365,36081121500,631660,0,Census Tract 1215,New York,Queens County,2001,3604,2164,2066,0,1908,93,65,98,98,0,98,0,0,1440,1208,0,1087,121,232,297,8.2,3.1,0.0,16.1,1101429.3125,5201.468208088821
50448,11365,11365,36081122300,495705,0,Census Tract 1223,New York,Queens County,1740,3030,1994,1878,0,1526,214,138,116,116,0,116,0,0,1036,914,0,827,87,122,260,8.6,7.3,0.0,11.8,864223.25,4413.08239253451
50449,11365,11365,36081122701,701334,0,Census Tract 1227.01,New York,Queens County,5390,9635,6683,5694,0,5345,45,304,989,989,0,989,0,0,2952,2186,0,2052,134,766,1070,11.1,5.3,0.0,25.9,1222656.046875,4958.52661703543
50450,11365,11365,36081122702,449732,0,Census Tract 1227.02,New York,Queens County,2455,5483,2900,2601,0,2257,198,146,299,299,0,224,75,0,2583,1976,15,1641,320,607,753,13.7,5.6,0.0,23.5,784027.96875,4699.2482150985
50450,11367,11367,36081122702,449732,0,Census Tract 1227.02,New York,Queens County,2455,5483,2900,2601,0,2257,198,146,299,299,0,224,75,0,2583,1976,15,1641,320,607,753,13.7,5.6,0.0,23.5,784027.96875,4699.2482150985
50451,11365,11365,36081124100,499010,0,Census Tract 1241,New York,Queens County,1939,3155,2104,1972,7,1866,66,33,132,132,0,120,12,0,1051,913,7,800,106,138,171,5.4,1.7,0.0,13.1,869768.3359375,4660.21318513372
50451,11366,11366,36081124100,499010,0,Census Tract 1241,New York,Queens County,1939,3155,2104,1972,7,1866,66,33,132,132,0,120,12,0,1051,913,7,800,106,138,171,5.4,1.7,0.0,13.1,869768.3359375,4660.21318513372
50452,11365,11365,36081124700,483459,0,Census Tract 1247,New York,Queens County,1433,2879,1612,1470,0,1433,0,37,142,99,0,99,0,43,1267,1165,0,1165,0,102,182,6.3,2.5,30.3,8.1,842692.46484375,4110.72349622057
50452,11366,11366,36081124700,483459,0,Census Tract 1247,New York,Queens County,1433,2879,1612,1470,0,1433,0,37,142,99,0,99,0,43,1267,1165,0,1165,0,102,182,6.3,2.5,30.3,8.1,842692.46484375,4110.72349622057
50453,11365,11365,36081125700,331894,0,Census Tract 1257,New York,Queens County,1392,2450,1554,1402,6,1299,87,10,152,152,0,152,0,0,896,837,18,766,53,59,69,2.8,0.7,0.0,6.6,578445.5859375,3407.6309312565804
50453,11366,11366,36081125700,331894,0,Census Tract 1257,New York,Queens County,1392,2450,1554,1402,6,1299,87,10,152,152,0,152,0,0,896,837,18,766,53,59,69,2.8,0.7,0.0,6.6,578445.5859375,3407.6309312565804
50454,11432,11432,36081126500,200793,0,Census Tract 1265,New York,Queens County,719,1389,815,724,0,674,45,5,91,84,0,84,0,7,574,526,0,511,15,48,60,4.3,0.7,7.7,8.4,349917.01953125,2836.52252390733
50455,11432,11432,36081126700,775341,0,Census Tract 1267,New York,Queens County,1173,2025,1272,1217,0,1135,38,44,55,55,0,55,0,0,753,705,0,678,27,48,92,4.5,3.6,0.0,6.4,1351151.234375,5911.87732258234
50456,11366,11366,36081127700,1069117,0,Census Tract 1277,New York,Queens County,1423,2577,1517,1433,10,1396,17,10,84,84,0,84,0,0,1060,1006,10,985,11,54,64,2.5,0.7,0.0,5.1,1863335.796875,5655.797376528791
50456,11423,11423,36081127700,1069117,0,Census Tract 1277,New York,Queens County,1423,2577,1517,1433,10,1396,17,10,84,84,0,84,0,0,1060,1006,10,985,11,54,64,2.5,0.7,0.0,5.1,1863335.796875,5655.797376528791
50456,11432,11432,36081127700,1069117,0,Census Tract 1277,New York,Queens County,1423,2577,1517,1433,10,1396,17,10,84,84,0,84,0,0,1060,1006,10,985,11,54,64,2.5,0.7,0.0,5.1,1863335.796875,5655.797376528791
50457,11364,11364,36081128300,1971930,0,Census Tract 1283,New York,Queens County,0,0,0,0,0,0,0,0,0,0,0,0,0,0,0,0,0,0,0,0,0,,,,,3437800.0078125,11304.854212548602
50457,11366,11366,36081128300,1971930,0,Census Tract 1283,New York,Queens County,0,0,0,0,0,0,0,0,0,0,0,0,0,0,0,0,0,0,0,0,0,,,,,3437800.0078125,11304.854212548602
50458,11364,11364,36081129102,991868,0,Census Tract 1291.02,New York,Queens County,1832,3054,1918,1832,0,1729,103,0,86,86,0,86,0,0,1136,1032,0,1001,31,104,104,3.4,0.0,0.0,9.2,1729071.15625,6397.91057214534
50458,11427,11427,36081129102,991868,0,Census Tract 1291.02,New York,Queens County,1832,3054,1918,1832,0,1729,103,0,86,86,0,86,0,0,1136,1032,0,1001,31,104,104,3.4,0.0,0.0,9.2,1729071.15625,6397.91057214534
50459,11364,11364,36081129103,458536,0,Census Tract 1291.03,New York,Queens County,1999,3319,2094,2009,0,1953,46,10,85,85,0,85,0,0,1225,1045,17,948,80,180,190,5.7,0.5,0.0,14.7,799462.22265625,4032.5961678747
50460,11364,11364,36081129104,708262,0,Census Tract 1291.04,New York,Queens County,2373,3650,2465,2383,0,2336,37,10,82,82,0,82,0,0,1185,1040,18,975,47,145,155,4.2,0.4,0.0,12.2,1234905.87890625,5498.78702834365
50461,11427,11427,36081130100,698698,0,Census Tract 1301,New York,Queens County,1737,3182,1881,1787,0,1705,32,50,94,94,0,94,0,0,1301,1089,0,958,131,212,262,8.2,2.8,0.0,16.3,1218071.33203125,4628.58115870669
50462,11365,11365,36081133300,695376,0,Census Tract 1333,New York,Queens County,1642,3061,1794,1642,0,1642,0,0,152,152,0,152,0,0,1267,1175,0,1164,11,92,92,3.0,0.0,0.0,7.3,1212220.4765625,5130.6448175492
50462,11366,11366,36081133300,695376,0,Census Tract 1333,New York,Queens County,1642,3061,1794,1642,0,1642,0,0,152,152,0,152,0,0,1267,1175,0,1164,11,92,92,3.0,0.0,0.0,7.3,1212220.4765625,5130.6448175492
50463,11366,11366,36081133900,226211,0,Census Tract 1339,New York,Queens County,561,1035,573,561,0,547,14,0,12,12,0,12,0,0,462,452,11,434,7,10,10,1.0,0.0,0.0,2.2,394309.12890625,2513.8705377543397
50464,11365,11365,36081134100,592973,0,Census Tract 1341,New York,Queens County,1644,2883,1782,1652,0,1619,25,8,130,130,0,130,0,0,1101,1056,0,1040,16,45,53,1.8,0.5,0.0,4.1,1033817.27734375,4905.1240171521395
50465,11365,11365,36081134700,1078957,0,Census Tract 1347,New York,Queens County,5074,8566,5583,5180,0,4943,131,106,403,314,0,314,0,89,2983,2667,14,2488,165,316,511,6.0,2.0,22.1,10.6,1881246.58984375,5674.42059650823
50465,11366,11366,36081134700,1078957,0,Census Tract 1347,New York,Queens County,5074,8566,5583,5180,0,4943,131,106,403,314,0,314,0,89,2983,2667,14,2488,165,316,511,6.0,2.0,22.1,10.6,1881246.58984375,5674.42059650823
50466,11364,11364,36081136700,772177,0,Census Tract 1367,New York,Queens County,3031,5229,3266,3062,26,2952,53,31,204,188,0,188,0,16,1963,1726,69,1548,109,237,284,5.4,1.0,7.8,12.1,1346601.984375,4741.4948069399
50467,11364,11364,36081137700,749685,0,Census Tract 1377,New York,Queens County,3121,5488,3449,3222,0,2896,225,101,227,168,0,168,0,59,2039,1895,0,1794,101,144,304,5.5,3.1,26.0,7.1,1307491.37890625,4839.9579731067
50468,11361,11361,36081138501,989756,49214,Census Tract 1385.01,New York,Queens County,2234,3867,2347,2278,0,2204,30,44,69,69,0,69,0,0,1520,1390,0,1345,45,130,174,4.5,1.9,0.0,8.6,1812437.04296875,5896.59213123412
50468,11364,11364,36081138501,989756,49214,Census Tract 1385.01,New York,Queens County,2234,3867,2347,2278,0,2204,30,44,69,69,0,69,0,0,1520,1390,0,1345,45,130,174,4.5,1.9,0.0,8.6,1812437.04296875,5896.59213123412
50469,11362,11362,36081138502,2354813,39269,Census Tract 1385.02,New York,Queens County,0,0,0,0,0,0,0,0,0,0,0,0,0,0,0,0,0,0,0,0,0,,,,,3990200.33203125,21011.7219999247
50470,11364,11364,36081139900,364201,0,Census Tract 1399,New York,Queens County,824,1398,853,841,0,818,6,17,12,12,0,12,0,0,545,502,0,502,0,43,60,4.3,2.0,0.0,7.9,635238.35546875,3302.92906288125
50471,11364,11364,36081140300,374326,0,Census Tract 1403,New York,Queens County,1230,2013,1324,1242,0,1221,9,12,82,82,0,82,0,0,689,639,0,639,0,50,62,3.1,1.0,0.0,7.3,652864.96484375,3330.12565950151
50472,11364,11364,36081140901,244502,0,Census Tract 1409.01,New York,Queens County,450,784,457,450,0,450,0,0,7,7,0,7,0,0,327,314,0,314,0,13,13,1.7,0.0,0.0,4.0,426415.078125,2710.17073502942
50473,11364,11364,36081140902,537655,0,Census Tract 1409.02,New York,Queens County,1413,2492,1490,1434,0,1384,29,21,56,56,0,56,0,0,1002,897,0,798,99,105,126,5.1,1.5,0.0,10.5,937638.9921875,4296.50237609137
50473,11365,11365,36081140902,537655,0,Census Tract 1409.02,New York,Queens County,1413,2492,1490,1434,0,1384,29,21,56,56,0,56,0,0,1002,897,0,798,99,105,126,5.1,1.5,0.0,10.5,937638.9921875,4296.50237609137
50474,11358,11358,36081141700,892286,0,Census Tract 1417,New York,Queens County,2211,4273,2429,2245,0,2032,179,34,184,184,0,184,0,0,1844,1658,0,1568,90,186,220,5.1,1.5,0.0,10.1,1556083.8671875,6046.92823908621
50474,11365,11365,36081141700,892286,0,Census Tract 1417,New York,Queens County,2211,4273,2429,2245,0,2032,179,34,184,184,0,184,0,0,1844,1658,0,1568,90,186,220,5.1,1.5,0.0,10.1,1556083.8671875,6046.92823908621
50475,11358,11358,36081142900,530341,0,Census Tract 1429,New York,Queens County,1665,2976,1804,1728,0,1619,46,63,76,76,0,76,0,0,1172,1033,0,960,73,139,202,6.8,3.6,0.0,11.9,925057.96484375,5158.3030975596
50475,11364,11364,36081142900,530341,0,Census Tract 1429,New York,Queens County,1665,2976,1804,1728,0,1619,46,63,76,76,0,76,0,0,1172,1033,0,960,73,139,202,6.8,3.6,0.0,11.9,925057.96484375,5158.3030975596
50475,11365,11365,36081142900,530341,0,Census Tract 1429,New York,Queens County,1665,2976,1804,1728,0,1619,46,63,76,76,0,76,0,0,1172,1033,0,960,73,139,202,6.8,3.6,0.0,11.9,925057.96484375,5158.3030975596
50476,11364,11364,36081143500,357723,0,Census Tract 1435,New York,Queens County,1129,1948,1182,1161,57,970,102,32,21,21,0,21,0,0,766,744,17,638,89,22,54,2.8,2.8,0.0,2.9,623990.23828125,3487.7051523250702
50477,11361,11361,36081144100,337064,0,Census Tract 1441,New York,Queens County,1574,2734,1581,1574,0,1554,20,0,7,7,0,7,0,0,1153,1129,0,1099,30,24,24,0.9,0.0,0.0,2.1,588003.7265625,3594.41717137055
50477,11364,11364,36081144100,337064,0,Census Tract 1441,New York,Queens County,1574,2734,1581,1574,0,1554,20,0,7,7,0,7,0,0,1153,1129,0,1099,30,24,24,0.9,0.0,0.0,2.1,588003.7265625,3594.41717137055
50478,11361,11361,36081144700,412781,0,Census Tract 1447,New York,Queens County,1409,2455,1528,1409,0,1308,101,0,119,119,0,113,6,0,927,808,0,761,47,119,119,4.8,0.0,0.0,12.8,720118.50390625,3452.5462109462105
50479,11358,11358,36081145101,251956,0,Census Tract 1451.01,New York,Queens County,555,975,587,571,0,555,0,16,16,16,0,16,0,0,388,308,0,308,0,80,96,9.8,2.8,0.0,20.6,439528.0234375,2763.2990384304803
50480,11361,11361,36081145102,343669,0,Census Tract 1451.02,New York,Queens County,1328,2196,1389,1332,0,1328,0,4,57,57,0,57,0,0,807,744,0,744,0,63,67,3.1,0.3,0.0,7.8,599483.5234375,3665.67594424771
50480,11364,11364,36081145102,343669,0,Census Tract 1451.02,New York,Queens County,1328,2196,1389,1332,0,1328,0,4,57,57,0,57,0,0,807,744,0,744,0,63,67,3.1,0.3,0.0,7.8,599483.5234375,3665.67594424771
50481,11358,11358,36081145900,372382,0,Census Tract 1459,New York,Queens County,1514,2473,1571,1537,0,1379,135,23,34,34,0,27,7,0,902,798,0,759,39,104,127,5.1,1.5,0.0,11.5,649593.02734375,3330.27564817117
50482,11361,11361,36081146300,323967,0,Census Tract 1463,New York,Queens County,1447,2271,1589,1480,0,1447,0,33,109,109,0,109,0,0,682,604,0,593,11,78,111,4.9,2.2,0.0,11.4,565219.546875,3003.3823355685604
50483,11361,11361,36081146700,354572,0,Census Tract 1467,New York,Queens County,1571,2278,1661,1632,0,1562,9,61,29,29,0,29,0,0,617,559,0,519,40,58,119,5.2,3.7,0.0,9.4,618657.3125,3845.9729481150603
50484,11361,11361,36081147100,421861,0,Census Tract 1471,New York,Queens County,1568,2704,1641,1579,0,1546,22,11,62,62,0,62,0,0,1063,932,0,924,8,131,142,5.3,0.7,0.0,12.3,736060.25,3892.84956920817
50485,11362,11362,36081147900,914228,0,Census Tract 1479,New York,Queens County,2180,3669,2356,2249,0,2079,101,69,107,107,0,107,0,0,1313,1253,0,1079,174,60,129,3.5,3.1,0.0,4.6,1595139.203125,5923.821706108721
50485,11363,11363,36081147900,914228,0,Census Tract 1479,New York,Queens County,2180,3669,2356,2249,0,2079,101,69,107,107,0,107,0,0,1313,1253,0,1079,174,60,129,3.5,3.1,0.0,4.6,1595139.203125,5923.821706108721
50486,11363,11363,36081148300,1334134,1047226,Census Tract 1483,New York,Queens County,1425,2329,1498,1442,0,1329,96,17,56,56,0,56,0,0,831,778,37,675,66,53,70,3.0,1.2,0.0,6.4,2361655.8125,7253.814582215021
50487,11362,11362,36081150701,877002,0,Census Tract 1507.01,New York,Queens County,1579,2627,1671,1601,0,1579,0,22,70,70,0,62,8,0,956,885,0,853,32,71,93,3.5,1.4,0.0,7.4,1530229.10546875,6166.021802994001
50488,11362,11362,36081150702,857353,0,Census Tract 1507.02,New York,Queens County,1338,2635,1478,1434,0,1253,85,96,44,44,0,44,0,0,1157,935,0,841,94,222,318,12.1,6.7,0.0,19.2,1496129.40234375,5364.61708277147
50489,11362,11362,36081152901,1399259,0,Census Tract 1529.01,New York,Queens County,3101,5888,3326,3167,0,3032,69,66,159,159,0,142,17,0,2562,2236,0,2199,37,326,392,6.7,2.1,0.0,12.7,2440756.234375,6602.92912362797
50490,11362,11362,36081152902,1038708,0,Census Tract 1529.02,New York,Queens County,2326,4358,2542,2432,0,2178,148,106,110,110,0,110,0,0,1816,1324,28,1242,54,492,598,13.7,4.4,0.0,27.1,1812226.0625,5799.41708406634
50491,11005,11004,36081155101,475147,0,Census Tract 1551.01,New York,Queens County,252,1749,314,314,0,203,49,62,0,0,0,0,0,0,1435,1151,12,998,141,284,346,19.8,19.7,,19.8,828916.109375,4120.61022601539
50492,11004,11004,36081155102,1441405,0,Census Tract 1551.02,New York,Queens County,4020,6548,4275,4072,0,3909,111,52,203,203,0,122,81,0,2273,1956,0,1876,80,317,369,5.6,1.3,0.0,13.9,2514186.46484375,9021.765553047779
50492,11040,11004,36081155102,1441405,0,Census Tract 1551.02,New York,Queens County,4020,6548,4275,4072,0,3909,111,52,203,203,0,122,81,0,2273,1956,0,1876,80,317,369,5.6,1.3,0.0,13.9,2514186.46484375,9021.765553047779
50492,11426,11426,36081155102,1441405,0,Census Tract 1551.02,New York,Queens County,4020,6548,4275,4072,0,3909,111,52,203,203,0,122,81,0,2273,1956,0,1876,80,317,369,5.6,1.3,0.0,13.9,2514186.46484375,9021.765553047779
50493,11426,11426,36081156700,1469691,0,Census Tract 1567,New York,Queens County,311,542,335,311,0,279,32,0,24,24,0,24,0,0,207,150,0,122,28,57,57,10.5,0.0,0.0,27.5,2562714.19140625,10343.7893044253
50493,11427,11427,36081156700,1469691,0,Census Tract 1567,New York,Queens County,311,542,335,311,0,279,32,0,24,24,0,24,0,0,207,150,0,122,28,57,57,10.5,0.0,0.0,27.5,2562714.19140625,10343.7893044253
50494,11001,11429,36081157101,1225445,0,Census Tract 1571.01,New York,Queens County,4364,6769,4620,4403,8,4233,123,39,217,217,0,217,0,0,2149,2031,9,1840,182,118,157,2.3,0.9,0.0,5.5,2136687.62109375,6762.360299032671
50494,11004,11004,36081157101,1225445,0,Census Tract 1571.01,New York,Queens County,4364,6769,4620,4403,8,4233,123,39,217,217,0,217,0,0,2149,2031,9,1840,182,118,157,2.3,0.9,0.0,5.5,2136687.62109375,6762.360299032671
50494,11426,11426,36081157101,1225445,0,Census Tract 1571.01,New York,Queens County,4364,6769,4620,4403,8,4233,123,39,217,217,0,217,0,0,2149,2031,9,1840,182,118,157,2.3,0.9,0.0,5.5,2136687.62109375,6762.360299032671
50495,11426,11426,36081157102,320045,0,Census Tract 1571.02,New York,Queens County,1052,1782,1143,1071,0,1046,6,19,72,72,0,72,0,0,639,599,0,588,11,40,59,3.3,1.8,0.0,6.3,557970.83203125,3797.8472113182
50496,11004,11004,36081157901,913547,0,Census Tract 1579.01,New York,Queens County,2779,4643,2926,2826,14,2667,98,47,100,100,0,93,7,0,1717,1507,61,1365,81,210,257,5.5,1.7,0.0,12.2,1593166.00390625,5436.765350771289
50496,11040,11004,36081157901,913547,0,Census Tract 1579.01,New York,Queens County,2779,4643,2926,2826,14,2667,98,47,100,100,0,93,7,0,1717,1507,61,1365,81,210,257,5.5,1.7,0.0,12.2,1593166.00390625,5436.765350771289
50497,11004,11004,36081157902,722590,0,Census Tract 1579.02,New York,Queens County,1998,3466,2130,2035,0,1798,200,37,95,95,0,95,0,0,1336,1205,9,1162,34,131,168,4.8,1.8,0.0,9.8,1260021.93359375,4617.41145810643
50498,11001,11429,36081157903,686014,0,Census Tract 1579.03,New York,Queens County,1792,3652,1950,1810,0,1748,44,18,140,140,0,140,0,0,1702,1415,0,1407,8,287,305,8.4,1.0,0.0,16.9,1195971.296875,5230.771464778711
50498,11004,11004,36081157903,686014,0,Census Tract 1579.03,New York,Queens County,1792,3652,1950,1810,0,1748,44,18,140,140,0,140,0,0,1702,1415,0,1407,8,287,305,8.4,1.0,0.0,16.9,1195971.296875,5230.771464778711
50499,11001,11429,36081161700,706697,0,Census Tract 1617,New York,Queens County,2507,4161,2598,2520,0,2507,0,13,78,78,0,78,0,0,1563,1516,36,1470,10,47,60,1.4,0.5,0.0,3.0,1231838.5234375,4835.628864062101
50499,11426,11426,36081161700,706697,0,Census Tract 1617,New York,Queens County,2507,4161,2598,2520,0,2507,0,13,78,78,0,78,0,0,1563,1516,36,1470,10,47,60,1.4,0.5,0.0,3.0,1231838.5234375,4835.628864062101
50500,11426,11426,36081162100,710238,0,Census Tract 1621,New York,Queens County,2891,4892,3169,3001,0,2698,193,110,168,130,0,109,21,38,1723,1582,0,1523,59,141,289,5.9,3.7,22.6,8.2,1237992.93359375,5346.69135091428
50500,11427,11427,36081162100,710238,0,Census Tract 1621,New York,Queens County,2891,4892,3169,3001,0,2698,193,110,168,130,0,109,21,38,1723,1582,0,1523,59,141,289,5.9,3.7,22.6,8.2,1237992.93359375,5346.69135091428
50500,11428,11428,36081162100,710238,0,Census Tract 1621,New York,Queens County,2891,4892,3169,3001,0,2698,193,110,168,130,0,109,21,38,1723,1582,0,1523,59,141,289,5.9,3.7,22.6,8.2,1237992.93359375,5346.69135091428
50501,10301,10301,36085000300,377461,2125639,Census Tract 3,New York,Richmond County,1060,1602,1162,1110,11,988,61,50,52,36,0,36,0,16,440,377,0,305,72,63,129,8.1,4.5,30.8,14.3,1013073.0546875,4129.34303435507
50502,10304,10304,36085000600,666769,2045497,Census Tract 6,New York,Richmond County,1022,2091,1148,1046,32,937,53,24,102,102,0,89,13,0,943,732,37,624,71,211,235,11.2,2.3,0.0,22.4,1660987.15625,8378.92173581838
50502,10305,10305,36085000600,666769,2045497,Census Tract 6,New York,Richmond County,1022,2091,1148,1046,32,937,53,24,102,102,0,89,13,0,943,732,37,624,71,211,235,11.2,2.3,0.0,22.4,1660987.15625,8378.92173581838
50503,10301,10301,36085000700,528114,638941,Census Tract 7,New York,Richmond County,1783,3829,2185,2066,0,1660,123,283,119,119,0,119,0,0,1644,1027,0,730,297,617,900,23.5,13.7,0.0,37.5,1105463.37890625,5080.60231380326
50504,10305,10305,36085000800,799851,0,Census Tract 8,New York,Richmond County,2273,4416,2668,2497,0,2226,47,224,171,171,0,160,11,0,1748,1438,0,1393,45,310,534,12.1,9.0,0.0,17.7,1389378.4765625,5858.01096500062
50505,10301,10301,36085000900,231877,0,Census Tract 9,New York,Richmond County,760,1361,875,808,0,646,114,48,67,51,0,40,11,16,486,361,0,288,73,125,189,13.9,5.9,23.9,25.7,403143.296875,3090.59094722651
50506,10301,10301,36085001100,325090,0,Census Tract 11,New York,Richmond County,1429,2690,1607,1552,0,1429,0,123,55,55,0,55,0,0,1083,1026,0,862,164,57,180,6.7,7.9,0.0,5.3,565146.20703125,3471.2709964629603
50507,10301,10301,36085001700,306004,0,Census Tract 17,New York,Richmond County,617,1084,687,635,0,576,41,18,52,52,0,52,0,0,397,316,4,307,5,81,99,9.1,2.8,0.0,20.4,531895.2421875,3077.3472398892304
50507,10304,10304,36085001700,306004,0,Census Tract 17,New York,Richmond County,617,1084,687,635,0,576,41,18,52,52,0,52,0,0,397,316,4,307,5,81,99,9.1,2.8,0.0,20.4,531895.2421875,3077.3472398892304
50508,10305,10305,36085001800,909602,1451608,Census Tract 18,New York,Richmond County,167,273,167,167,0,167,0,0,0,0,0,0,0,0,106,106,0,102,4,0,0,0.0,0.0,,0.0,1827063.71484375,6297.1710285371
50509,10305,10305,36085002001,513525,0,Census Tract 20.01,New York,Richmond County,1264,2237,1447,1318,0,1211,53,54,129,129,0,129,0,0,790,741,0,732,9,49,103,4.6,4.1,0.0,6.2,891885.84765625,4423.779767322179
50510,10305,10305,36085002002,771749,0,Census Tract 20.02,New York,Richmond County,1367,2823,1473,1427,0,1333,34,60,46,43,0,35,8,3,1350,1191,14,1058,119,159,222,7.9,4.2,6.5,11.8,1340146.08984375,5053.26861150331
50511,10301,10301,36085002100,864875,2017877,Census Tract 21,New York,Richmond County,1664,3093,1787,1713,7,1454,203,49,74,74,0,62,12,0,1306,1067,0,744,323,239,288,9.3,2.9,0.0,18.3,2322377.296875,8193.85102367261
50511,10304,10304,36085002100,864875,2017877,Census Tract 21,New York,Richmond County,1664,3093,1787,1713,7,1454,203,49,74,74,0,62,12,0,1306,1067,0,744,323,239,288,9.3,2.9,0.0,18.3,2322377.296875,8193.85102367261
50512,10304,10304,36085002700,250358,0,Census Tract 27,New York,Richmond County,484,935,573,535,0,448,36,51,38,38,0,38,0,0,362,293,0,251,42,69,120,12.8,9.5,0.0,19.1,435034.171875,2705.6721311340602
50513,10304,10304,36085002900,526903,0,Census Tract 29,New York,Richmond County,1328,3698,1639,1591,17,1178,133,263,48,48,0,48,0,0,2059,1500,7,1267,226,559,822,22.2,16.5,0.0,27.1,915464.85546875,4378.01076914899
50514,10301,10301,36085003300,851963,0,Census Tract 33,New York,Richmond County,1876,2860,2081,1943,0,1722,154,67,138,138,0,138,0,0,779,696,0,675,21,83,150,5.2,3.4,0.0,10.7,1480493.66796875,7466.47385739145
50514,10304,10304,36085003300,851963,0,Census Tract 33,New York,Richmond County,1876,2860,2081,1943,0,1722,154,67,138,138,0,138,0,0,779,696,0,675,21,83,150,5.2,3.4,0.0,10.7,1480493.66796875,7466.47385739145
50515,10305,10305,36085003600,409183,0,Census Tract 36,New York,Richmond County,1240,2122,1398,1305,18,1156,66,65,93,93,0,93,0,0,724,678,5,663,10,46,111,5.2,5.0,0.0,6.4,710748.1875,4250.906861832071
50516,10301,10301,36085003900,583060,0,Census Tract 39,New York,Richmond County,1011,1769,1150,1116,0,917,94,105,34,34,0,29,5,0,619,512,0,461,51,107,212,12.0,9.4,0.0,17.3,1013078.2578125,4630.49734828954
50517,10304,10304,36085004000,1192751,0,Census Tract 40,New York,Richmond County,4751,10082,5431,4917,0,4062,689,166,514,427,0,427,0,87,4651,3963,0,2954,1009,688,941,9.3,3.4,16.9,14.8,2071960.8984375,6717.35635855413
50518,10301,10301,36085004700,895658,0,Census Tract 47,New York,Richmond County,997,1873,1100,1043,0,934,63,46,57,57,0,57,0,0,773,746,0,720,26,27,73,3.9,4.4,0.0,3.5,1555900.03125,5907.6745354368395
50518,10304,10304,36085004700,895658,0,Census Tract 47,New York,Richmond County,997,1873,1100,1043,0,934,63,46,57,57,0,57,0,0,773,746,0,720,26,27,73,3.9,4.4,0.0,3.5,1555900.03125,5907.6745354368395
50519,10304,10304,36085005000,792524,42337,Census Tract 50,New York,Richmond County,1817,3264,2069,1903,0,1706,111,86,166,166,0,166,0,0,1195,971,0,860,111,224,310,9.5,4.5,0.0,18.7,1449849.2890625,5663.45905604852
50519,10305,10305,36085005000,792524,42337,Census Tract 50,New York,Richmond County,1817,3264,2069,1903,0,1706,111,86,166,166,0,166,0,0,1195,971,0,860,111,224,310,9.5,4.5,0.0,18.7,1449849.2890625,5663.45905604852
50520,10301,10301,36085005900,1387005,6193,Census Tract 59,New York,Richmond County,1515,2478,1548,1515,0,1501,14,0,33,33,0,33,0,0,930,762,0,721,41,168,168,6.8,0.0,0.0,18.1,2421011.80078125,7376.2021733436495
50520,10310,10310,36085005900,1387005,6193,Census Tract 59,New York,Richmond County,1515,2478,1548,1515,0,1501,14,0,33,33,0,33,0,0,930,762,0,721,41,168,168,6.8,0.0,0.0,18.1,2421011.80078125,7376.2021733436495
50521,10305,10305,36085006400,709804,0,Census Tract 64,New York,Richmond County,1301,2428,1558,1346,0,1301,0,45,212,190,0,190,0,22,870,689,0,650,39,181,248,10.2,3.3,10.4,20.8,1232423.390625,5096.88846390704
50522,10301,10301,36085006700,950892,1786,Census Tract 67,New York,Richmond County,1231,1986,1302,1240,0,1196,35,9,62,62,0,62,0,0,684,596,0,562,34,88,97,4.9,0.7,0.0,12.9,1655990.21875,6495.59855201979
50522,10310,10310,36085006700,950892,1786,Census Tract 67,New York,Richmond County,1231,1986,1302,1240,0,1196,35,9,62,62,0,62,0,0,684,596,0,562,34,88,97,4.9,0.7,0.0,12.9,1655990.21875,6495.59855201979
50523,10305,10305,36085007000,2640265,866081,Census Tract 70,New York,Richmond County,3494,6639,3730,3688,0,3248,246,194,42,42,0,42,0,0,2909,2481,0,2375,106,428,622,9.4,5.3,0.0,14.7,4736864.28125,9638.31132519266
50524,10305,10305,36085007400,541258,442359,Census Tract 74,New York,Richmond County,2018,3615,2266,2149,47,1893,78,131,117,117,0,108,9,0,1349,1213,0,1162,51,136,267,7.4,6.1,0.0,10.1,1146757.796875,4314.83973753908
50525,10301,10301,36085007500,480639,0,Census Tract 75,New York,Richmond County,1294,2693,1431,1377,0,1171,123,83,54,54,0,54,0,0,1262,1101,0,1023,78,161,244,9.1,6.0,0.0,12.8,835433.00390625,4189.163789035039
50526,10301,10301,36085007700,248536,0,Census Tract 77,New York,Richmond County,471,1019,563,508,0,403,68,37,55,42,0,33,9,13,456,338,0,264,74,118,168,16.5,7.3,23.6,25.9,432053.921875,2935.21653972206
50527,10301,10301,36085008100,821491,208775,Census Tract 81,New York,Richmond County,1532,3413,1722,1623,0,1397,135,91,99,99,0,99,0,0,1691,1112,0,954,158,579,670,19.6,5.6,0.0,34.2,1428372.1640625,4989.48822179959
50528,10304,10304,36085009601,776279,0,Census Tract 96.01,New York,Richmond County,1603,3362,1736,1675,19,1522,62,72,61,61,0,61,0,0,1626,1446,72,1235,139,180,252,7.5,4.3,0.0,11.1,1347822.6328125,5235.94102199775
50528,10305,10305,36085009601,776279,0,Census Tract 96.01,New York,Richmond County,1603,3362,1736,1675,19,1522,62,72,61,61,0,61,0,0,1626,1446,72,1235,139,180,252,7.5,4.3,0.0,11.1,1347822.6328125,5235.94102199775
50529,10304,10304,36085009602,617605,0,Census Tract 96.02,New York,Richmond County,1478,2813,1720,1550,0,1449,29,72,170,129,0,129,0,41,1093,850,0,831,19,243,356,12.7,4.6,24.1,22.2,1072133.18359375,4095.4721887876003
50529,10305,10305,36085009602,617605,0,Census Tract 96.02,New York,Richmond County,1478,2813,1720,1550,0,1449,29,72,170,129,0,129,0,41,1093,850,0,831,19,243,356,12.7,4.6,24.1,22.2,1072133.18359375,4095.4721887876003
50530,10301,10301,36085009700,1148682,520483,Census Tract 97,New York,Richmond County,1836,3173,1906,1869,0,1818,18,33,37,37,0,37,0,0,1267,1102,16,1068,18,165,198,6.2,1.8,0.0,13.0,1999351.34375,6468.84903498999
50530,10310,10310,36085009700,1148682,520483,Census Tract 97,New York,Richmond County,1836,3173,1906,1869,0,1818,18,33,37,37,0,37,0,0,1267,1102,16,1068,18,165,198,6.2,1.8,0.0,13.0,1999351.34375,6468.84903498999
50531,10310,10310,36085010500,816706,0,Census Tract 105,New York,Richmond County,1743,3498,2050,1893,18,1565,160,150,157,157,0,157,0,0,1448,1114,9,991,114,334,484,13.8,7.9,0.0,23.1,1419578.18359375,5031.45415492178
50532,10305,10305,36085011201,1607938,585976,Census Tract 112.01,New York,Richmond County,2595,4872,2931,2803,0,2458,137,208,128,128,0,128,0,0,1941,1690,0,1545,145,251,459,9.4,7.4,0.0,12.9,2786628.953125,7272.658881983531
50532,10306,10306,36085011201,1607938,585976,Census Tract 112.01,New York,Richmond County,2595,4872,2931,2803,0,2458,137,208,128,128,0,128,0,0,1941,1690,0,1545,145,251,459,9.4,7.4,0.0,12.9,2786628.953125,7272.658881983531
50533,10305,10305,36085011202,1977524,741225,Census Tract 112.02,New York,Richmond County,2313,4399,2544,2449,0,2260,53,136,95,95,0,95,0,0,1855,1311,0,1212,99,544,680,15.5,5.6,0.0,29.3,3439491.60546875,7507.39209547972
50533,10306,10306,36085011202,1977524,741225,Census Tract 112.02,New York,Richmond County,2313,4399,2544,2449,0,2260,53,136,95,95,0,95,0,0,1855,1311,0,1212,99,544,680,15.5,5.6,0.0,29.3,3439491.60546875,7507.39209547972
50534,10304,10304,36085011401,526901,0,Census Tract 114.01,New York,Richmond County,993,2285,1134,1057,0,842,151,64,77,77,0,77,0,0,1151,893,0,714,179,258,322,14.1,6.1,0.0,22.4,914531.30859375,3873.6580458901794
50534,10305,10305,36085011401,526901,0,Census Tract 114.01,New York,Richmond County,993,2285,1134,1057,0,842,151,64,77,77,0,77,0,0,1151,893,0,714,179,258,322,14.1,6.1,0.0,22.4,914531.30859375,3873.6580458901794
50534,10306,10306,36085011401,526901,0,Census Tract 114.01,New York,Richmond County,993,2285,1134,1057,0,842,151,64,77,77,0,77,0,0,1151,893,0,714,179,258,322,14.1,6.1,0.0,22.4,914531.30859375,3873.6580458901794
50535,10306,10306,36085011402,579280,0,Census Tract 114.02,New York,Richmond County,1596,2971,1816,1716,0,1529,67,120,100,92,0,92,0,8,1155,1026,0,1019,7,129,257,8.7,7.0,8.0,11.2,1005318.28515625,4153.216064498401
50536,10310,10310,36085012100,741984,0,Census Tract 121,New York,Richmond County,1407,2513,1610,1553,0,1382,25,146,57,57,0,47,10,0,903,739,0,683,56,164,310,12.3,9.4,0.0,18.2,1289388.91015625,4460.50885790924
50537,10306,10306,36085012200,827812,0,Census Tract 122,New York,Richmond County,1802,3307,1998,1836,0,1683,119,34,162,162,0,162,0,0,1309,1247,0,1094,153,62,96,2.9,1.9,0.0,4.7,1436416.56640625,4848.90560069875
50538,10310,10310,36085012500,457096,0,Census Tract 125,New York,Richmond County,1060,2310,1235,1165,0,948,112,105,70,70,0,60,10,0,1075,959,0,666,293,116,221,9.6,9.0,0.0,10.8,794396.37890625,4246.03116424312
50539,10306,10306,36085012804,897166,342703,Census Tract 128.04,New York,Richmond County,1731,3171,1936,1868,0,1665,66,137,68,68,0,66,2,0,1235,1093,0,1073,20,142,279,8.8,7.3,0.0,11.5,1556235.59375,5524.166006761109
50540,10306,10306,36085012805,1006608,344653,Census Tract 128.05,New York,Richmond County,1167,2149,1234,1169,0,992,175,2,65,65,0,65,0,0,915,815,0,695,120,100,102,4.7,0.2,0.0,10.9,1745918.1640625,6445.52586814604
50541,10306,10306,36085012806,1319470,580167,Census Tract 128.06,New York,Richmond County,2324,4537,2486,2356,0,2125,199,32,130,119,0,119,0,11,2051,1756,23,1445,288,295,338,7.4,1.4,8.5,14.4,2288399.17578125,6398.08552491343
50542,10306,10306,36085013201,469586,0,Census Tract 132.01,New York,Richmond County,664,1202,727,692,0,658,6,28,35,30,0,30,0,5,475,370,10,324,36,105,138,11.5,4.0,14.3,22.1,814546.3203125,4028.39730901905
50543,10306,10306,36085013203,1027705,5153,Census Tract 132.03,New York,Richmond County,2191,4579,2409,2197,0,1912,279,6,212,212,0,212,0,0,2170,1886,0,1731,155,284,290,6.3,0.3,0.0,13.1,1790817.2109375,6094.22520973033
50543,10308,10308,36085013203,1027705,5153,Census Tract 132.03,New York,Richmond County,2191,4579,2409,2197,0,1912,279,6,212,212,0,212,0,0,2170,1886,0,1731,155,284,290,6.3,0.3,0.0,13.1,1790817.2109375,6094.22520973033
50544,10306,10306,36085013204,1045193,0,Census Tract 132.04,New York,Richmond County,2200,4024,2534,2409,0,2175,25,209,125,125,0,98,27,0,1490,1252,0,1126,126,238,447,11.1,8.7,0.0,16.0,1812717.17578125,6110.94591329182
50545,10310,10310,36085013301,67337,0,Census Tract 133.01,New York,Richmond County,194,946,260,236,0,188,6,42,24,24,0,24,0,0,686,356,0,230,126,330,372,39.3,17.8,0.0,48.1,117049.16015625,1377.7488336762801
50546,10302,10302,36085013302,849327,0,Census Tract 133.02,New York,Richmond County,1129,2255,1241,1178,0,972,157,49,63,63,0,35,28,0,1014,971,0,650,321,43,92,4.1,4.2,0.0,4.2,1476368.37890625,6165.5982960865
50546,10310,10310,36085013302,849327,0,Census Tract 133.02,New York,Richmond County,1129,2255,1241,1178,0,972,157,49,63,63,0,35,28,0,1014,971,0,650,321,43,92,4.1,4.2,0.0,4.2,1476368.37890625,6165.5982960865
50547,10306,10306,36085013400,850704,0,Census Tract 134,New York,Richmond County,1822,3359,1933,1863,112,1618,92,41,70,70,0,70,0,0,1426,1284,0,1134,150,142,183,5.4,2.2,0.0,10.0,1475869.453125,5085.9886779371
50548,10306,10306,36085013800,1407436,0,Census Tract 138,New York,Richmond County,2772,4998,2965,2838,0,2697,75,66,127,127,0,127,0,0,2033,1683,0,1619,64,350,416,8.3,2.3,0.0,17.2,2441773.87109375,6772.82569731967
50549,10302,10302,36085014100,311364,0,Census Tract 141,New York,Richmond County,975,1810,1138,1075,5,912,58,100,63,57,0,57,0,6,672,560,0,546,14,112,218,12.0,9.3,9.5,16.7,541125.14453125,3178.2510518958097
50549,10310,10310,36085014100,311364,0,Census Tract 141,New York,Richmond County,975,1810,1138,1075,5,912,58,100,63,57,0,57,0,6,672,560,0,546,14,112,218,12.0,9.3,9.5,16.7,541125.14453125,3178.2510518958097
50550,10308,10308,36085014604,1129002,0,Census Tract 146.04,New York,Richmond County,2956,5785,3276,3070,0,2872,84,114,206,206,0,206,0,0,2509,2301,26,2085,190,208,322,5.6,3.7,0.0,8.3,1957531.30859375,5979.6881827251
50550,10312,10312,36085014604,1129002,0,Census Tract 146.04,New York,Richmond County,2956,5785,3276,3070,0,2872,84,114,206,206,0,206,0,0,2509,2301,26,2085,190,208,322,5.6,3.7,0.0,8.3,1957531.30859375,5979.6881827251
50551,10308,10308,36085014605,875799,6861,Census Tract 146.05,New York,Richmond County,1873,3346,1950,1901,9,1690,174,28,49,49,0,49,0,0,1396,1310,17,1115,178,86,114,3.4,1.5,0.0,6.2,1530803.97265625,5832.80000775247
50552,10306,10306,36085014606,1768736,192,Census Tract 146.06,New York,Richmond County,3478,5418,3599,3478,0,3247,231,0,121,121,0,107,14,0,1819,1734,0,1489,245,85,85,1.6,0.0,0.0,4.7,3068210.98828125,8088.834482273421
50552,10308,10308,36085014606,1768736,192,Census Tract 146.06,New York,Richmond County,3478,5418,3599,3478,0,3247,231,0,121,121,0,107,14,0,1819,1734,0,1489,245,85,85,1.6,0.0,0.0,4.7,3068210.98828125,8088.834482273421
50553,10308,10308,36085014607,683478,0,Census Tract 146.07,New York,Richmond County,1993,3766,2129,2037,0,1834,159,44,92,92,0,87,5,0,1637,1344,0,1249,95,293,337,8.9,2.2,0.0,17.9,1185293.13671875,4646.25288171541
50553,10312,10312,36085014607,683478,0,Census Tract 146.07,New York,Richmond County,1993,3766,2129,2037,0,1834,159,44,92,92,0,87,5,0,1637,1344,0,1249,95,293,337,8.9,2.2,0.0,17.9,1185293.13671875,4646.25288171541
50554,10308,10308,36085014608,448628,0,Census Tract 146.08,New York,Richmond County,1848,3198,2074,1848,29,1783,36,0,226,226,0,225,1,0,1124,1055,11,1023,21,69,69,2.2,0.0,0.0,6.1,778050.9375,3798.3504505135998
50555,10301,10301,36085014700,1668067,4948,Census Tract 147,New York,Richmond County,1672,2721,1707,1688,0,1496,176,16,19,19,0,19,0,0,1014,933,0,910,23,81,97,3.6,0.9,0.0,8.0,2906733.84765625,7379.23840049087
50555,10310,10310,36085014700,1668067,4948,Census Tract 147,New York,Richmond County,1672,2721,1707,1688,0,1496,176,16,19,19,0,19,0,0,1014,933,0,910,23,81,97,3.6,0.9,0.0,8.0,2906733.84765625,7379.23840049087
50555,10314,10314,36085014700,1668067,4948,Census Tract 147,New York,Richmond County,1672,2721,1707,1688,0,1496,176,16,19,19,0,19,0,0,1014,933,0,910,23,81,97,3.6,0.9,0.0,8.0,2906733.84765625,7379.23840049087
50556,10302,10302,36085015100,1004257,0,Census Tract 151,New York,Richmond County,2486,4122,2617,2486,69,2405,12,0,131,131,0,131,0,0,1505,1163,61,1043,59,342,342,8.3,0.0,0.0,22.7,1744838.62109375,5723.9550406852195
50556,10310,10310,36085015100,1004257,0,Census Tract 151,New York,Richmond County,2486,4122,2617,2486,69,2405,12,0,131,131,0,131,0,0,1505,1163,61,1043,59,342,342,8.3,0.0,0.0,22.7,1744838.62109375,5723.9550406852195
50556,10314,10314,36085015100,1004257,0,Census Tract 151,New York,Richmond County,2486,4122,2617,2486,69,2405,12,0,131,131,0,131,0,0,1505,1163,61,1043,59,342,342,8.3,0.0,0.0,22.7,1744838.62109375,5723.9550406852195
50558,10308,10308,36085015601,1429954,0,Census Tract 156.01,New York,Richmond County,2983,5326,3193,2983,0,2967,16,0,210,210,0,210,0,0,2133,1763,0,1624,139,370,370,6.9,0.0,0.0,17.3,2478760.46875,6336.232743050079
50558,10312,10312,36085015601,1429954,0,Census Tract 156.01,New York,Richmond County,2983,5326,3193,2983,0,2967,16,0,210,210,0,210,0,0,2133,1763,0,1624,139,370,370,6.9,0.0,0.0,17.3,2478760.46875,6336.232743050079
50559,10312,10312,36085015602,881072,0,Census Tract 156.02,New York,Richmond County,1523,2832,1584,1523,0,1469,54,0,61,61,0,61,0,0,1248,1132,13,1077,42,116,116,4.1,0.0,0.0,9.3,1527021.484375,5395.53760923602
50560,10308,10308,36085015603,969267,2670770,Census Tract 156.03,New York,Richmond County,2223,3628,2362,2230,0,2004,219,7,132,132,0,107,25,0,1266,1240,7,992,241,26,33,0.9,0.3,0.0,2.1,1814863.41015625,9091.52674279037
50560,10312,10312,36085015603,969267,2670770,Census Tract 156.03,New York,Richmond County,2223,3628,2362,2230,0,2004,219,7,132,132,0,107,25,0,1266,1240,7,992,241,26,33,0.9,0.3,0.0,2.1,1814863.41015625,9091.52674279037
50561,10301,10301,36085016901,823443,0,Census Tract 169.01,New York,Richmond County,1365,2652,1587,1483,0,1340,25,118,104,104,0,103,1,0,1065,924,0,839,85,141,259,9.8,8.0,0.0,13.2,1430371.7734375,6496.487499278261
50561,10314,10314,36085016901,823443,0,Census Tract 169.01,New York,Richmond County,1365,2652,1587,1483,0,1340,25,118,104,104,0,103,1,0,1065,924,0,839,85,141,259,9.8,8.0,0.0,13.2,1430371.7734375,6496.487499278261
50562,10312,10312,36085017005,1497211,681,Census Tract 170.05,New York,Richmond County,2664,4349,2832,2737,0,2537,127,73,95,95,0,85,10,0,1517,1317,0,1119,198,200,273,6.3,2.7,0.0,13.2,2596314.29296875,7461.92310331723
50563,10312,10312,36085017007,1460404,1188,Census Tract 170.07,New York,Richmond County,2577,4200,2745,2616,0,2331,246,39,129,129,0,112,17,0,1455,1433,0,1284,149,22,61,1.5,1.5,0.0,1.5,2534826.109375,6377.91402178525
50564,10312,10312,36085017008,1036915,0,Census Tract 170.08,New York,Richmond County,3499,6122,3704,3499,0,3470,29,0,205,205,0,195,10,0,2418,2274,0,2195,79,144,144,2.4,0.0,0.0,6.0,1798178.55859375,6904.75559067222
50565,10312,10312,36085017009,1074717,0,Census Tract 170.09,New York,Richmond County,2010,3671,2128,2059,0,1914,96,49,69,54,0,54,0,15,1543,1393,0,1316,77,150,214,5.8,2.4,21.7,9.7,1863025.6171875,5675.1581641334105
50566,10312,10312,36085017010,1110521,219,Census Tract 170.10,New York,Richmond County,4360,7247,4607,4383,0,4094,266,23,224,224,0,180,44,0,2640,2514,0,2212,302,126,149,2.1,0.5,0.0,4.8,1925927.75390625,6044.53579732366
50567,10312,10312,36085017011,719396,0,Census Tract 170.11,New York,Richmond County,2158,3784,2324,2192,27,2051,80,34,132,132,0,132,0,0,1460,1281,0,1172,109,179,213,5.6,1.6,0.0,12.3,1247166.66015625,4600.96205996802
50568,10312,10312,36085017012,1004724,0,Census Tract 170.12,New York,Richmond County,1765,3633,1901,1818,0,1643,122,53,83,83,0,83,0,0,1732,1606,8,1462,136,126,179,4.9,2.9,0.0,7.3,1742201.22265625,6435.5097363277
50569,10314,10314,36085017300,343224,0,Census Tract 173,New York,Richmond County,749,1847,845,787,0,692,57,38,58,28,0,28,0,30,1002,792,44,645,103,210,278,15.1,4.8,51.7,21.0,596075.97265625,3217.68913763709
50570,10312,10312,36085017600,3265507,2161742,Census Tract 176,New York,Richmond County,2288,3946,2439,2322,0,2259,29,34,117,117,0,117,0,0,1507,1347,0,1201,146,160,194,4.9,1.5,0.0,10.6,5918051.32421875,10424.1271156022
50571,10301,10301,36085017700,3521995,2825,Census Tract 177,New York,Richmond County,2346,4923,2550,2449,0,2099,247,103,101,90,0,90,0,11,2373,2008,0,1956,52,365,479,9.7,4.2,10.9,15.4,6121033.91015625,11163.709607704299
50571,10304,10304,36085017700,3521995,2825,Census Tract 177,New York,Richmond County,2346,4923,2550,2449,0,2099,247,103,101,90,0,90,0,11,2373,2008,0,1956,52,365,479,9.7,4.2,10.9,15.4,6121033.91015625,11163.709607704299
50571,10314,10314,36085017700,3521995,2825,Census Tract 177,New York,Richmond County,2346,4923,2550,2449,0,2099,247,103,101,90,0,90,0,11,2373,2008,0,1956,52,365,479,9.7,4.2,10.9,15.4,6121033.91015625,11163.709607704299
50572,10304,10304,36085018100,5198683,31114,Census Tract 181,New York,Richmond County,1266,2338,1349,1287,0,1187,79,21,62,62,0,51,11,0,989,836,0,825,11,153,174,7.4,1.6,0.0,15.5,9078239.359375,13018.0004498692
50572,10306,10306,36085018100,5198683,31114,Census Tract 181,New York,Richmond County,1266,2338,1349,1287,0,1187,79,21,62,62,0,51,11,0,989,836,0,825,11,153,174,7.4,1.6,0.0,15.5,9078239.359375,13018.0004498692
50572,10314,10314,36085018100,5198683,31114,Census Tract 181,New York,Richmond County,1266,2338,1349,1287,0,1187,79,21,62,62,0,51,11,0,989,836,0,825,11,153,174,7.4,1.6,0.0,15.5,9078239.359375,13018.0004498692
50573,10314,10314,36085018701,385717,0,Census Tract 187.01,New York,Richmond County,830,1491,892,830,0,761,69,0,62,62,0,62,0,0,599,501,0,384,117,98,98,6.6,0.0,0.0,16.4,669986.47265625,3458.03494769323
50574,10314,10314,36085018702,1013301,0,Census Tract 187.02,New York,Richmond County,3081,5901,3434,3321,0,2891,190,240,113,113,0,95,18,0,2467,2185,0,2027,158,282,522,8.8,7.2,0.0,11.4,1759731.72265625,5241.161978807249
50575,10314,10314,36085018901,1086481,0,Census Tract 189.01,New York,Richmond County,2158,4564,2411,2276,0,2069,89,118,135,116,0,116,0,19,2153,1968,0,1925,43,185,322,7.1,5.2,14.1,8.6,1887268.22265625,5984.24565987052
50576,10314,10314,36085018902,796477,0,Census Tract 189.02,New York,Richmond County,2326,4055,2505,2376,30,2075,221,50,129,129,0,129,0,0,1550,1437,0,1272,165,113,163,4.0,2.1,0.0,7.3,1383242.67578125,5594.6624896678695
50577,10314,10314,36085019700,300157,0,Census Tract 197,New York,Richmond County,838,1484,878,859,6,818,14,21,19,19,0,19,0,0,606,537,0,496,41,69,90,6.1,2.4,0.0,11.4,521461.703125,3654.48614426695
50578,10307,10307,36085019800,5586388,4546063,Census Tract 198,New York,Richmond County,3449,5163,3464,3464,45,3254,150,15,0,0,0,0,0,0,1699,1652,43,1376,233,47,62,1.2,0.4,,2.8,10327028.1640625,22228.999072792598
50578,10309,10309,36085019800,5586388,4546063,Census Tract 198,New York,Richmond County,3449,5163,3464,3464,45,3254,150,15,0,0,0,0,0,0,1699,1652,43,1376,233,47,62,1.2,0.4,,2.8,10327028.1640625,22228.999072792598
50578,10312,10312,36085019800,5586388,4546063,Census Tract 198,New York,Richmond County,3449,5163,3464,3464,45,3254,150,15,0,0,0,0,0,0,1699,1652,43,1376,233,47,62,1.2,0.4,,2.8,10327028.1640625,22228.999072792598
50579,10302,10302,36085020100,628177,0,Census Tract 201,New York,Richmond County,1625,2724,1746,1688,0,1490,135,63,58,58,0,45,13,0,978,892,0,774,118,86,149,5.5,3.7,0.0,8.8,1091560.62109375,5810.314631327321
50579,10314,10314,36085020100,628177,0,Census Tract 201,New York,Richmond County,1625,2724,1746,1688,0,1490,135,63,58,58,0,45,13,0,978,892,0,774,118,86,149,5.5,3.7,0.0,8.8,1091560.62109375,5810.314631327321
50580,10302,10302,36085020700,959812,525979,Census Tract 207,New York,Richmond County,1597,4223,2052,1984,0,1439,158,387,68,45,0,45,0,23,2171,1372,9,1101,262,799,1209,28.6,19.5,33.8,36.8,1664151.90625,7392.8779874926795
50580,10303,10303,36085020700,959812,525979,Census Tract 207,New York,Richmond County,1597,4223,2052,1984,0,1439,158,387,68,45,0,45,0,23,2171,1372,9,1101,262,799,1209,28.6,19.5,33.8,36.8,1664151.90625,7392.8779874926795
50581,10309,10309,36085020801,2597062,7616,Census Tract 208.01,New York,Richmond County,4098,7526,4346,4155,0,3979,119,57,191,191,0,174,17,0,3180,2775,0,2548,227,405,462,6.1,1.4,0.0,12.7,4515968.0859375,8276.283551640041
50581,10312,10312,36085020801,2597062,7616,Census Tract 208.01,New York,Richmond County,4098,7526,4346,4155,0,3979,119,57,191,191,0,174,17,0,3180,2775,0,2548,227,405,462,6.1,1.4,0.0,12.7,4515968.0859375,8276.283551640041
50582,10309,10309,36085020803,2098037,0,Census Tract 208.03,New York,Richmond County,3315,5486,3494,3387,0,3035,280,72,107,107,0,107,0,0,1992,1697,0,1451,246,295,367,6.7,2.1,0.0,14.8,3635843.59765625,7772.307171400809
50583,10309,10309,36085020804,1330758,0,Census Tract 208.04,New York,Richmond County,2573,4894,2760,2696,0,2418,155,123,64,64,0,51,13,0,2134,1988,0,1910,78,146,269,5.5,4.6,0.0,6.8,2306364.7734375,6481.327889821159
50583,10312,10312,36085020804,1330758,0,Census Tract 208.04,New York,Richmond County,2573,4894,2760,2696,0,2418,155,123,64,64,0,51,13,0,2134,1988,0,1910,78,146,269,5.5,4.6,0.0,6.8,2306364.7734375,6481.327889821159
50584,10302,10302,36085021300,784578,0,Census Tract 213,New York,Richmond County,2025,3739,2088,2035,0,1738,287,10,53,53,0,53,0,0,1651,1410,0,1206,204,241,251,6.7,0.5,0.0,14.6,1363678.41015625,5826.64462922579
50584,10303,10303,36085021300,784578,0,Census Tract 213,New York,Richmond County,2025,3739,2088,2035,0,1738,287,10,53,53,0,53,0,0,1651,1410,0,1206,204,241,251,6.7,0.5,0.0,14.6,1363678.41015625,5826.64462922579
50585,10303,10303,36085022300,766316,627212,Census Tract 223,New York,Richmond County,1023,1968,1162,1104,0,1014,9,81,58,58,0,58,0,0,806,731,0,681,50,75,156,7.9,7.3,0.0,9.3,1338693.3046875,7716.706011201791
50586,10309,10309,36085022600,8026558,2027147,Census Tract 226,New York,Richmond County,3901,6386,4172,4064,0,3646,255,163,108,108,0,77,31,0,2214,2005,0,1936,69,209,372,5.8,4.0,0.0,9.4,14028888.8046875,19956.8168502711
50587,10312,10312,36085022800,9566220,1820543,Census Tract 228,New York,Richmond County,8,12,8,8,0,8,0,0,0,0,0,0,0,0,4,4,0,4,0,0,0,0.0,0.0,,0.0,17032541.0546875,45603.405272258206
50587,10314,10314,36085022800,9566220,1820543,Census Tract 228,New York,Richmond County,8,12,8,8,0,8,0,0,0,0,0,0,0,0,4,4,0,4,0,0,0,0.0,0.0,,0.0,17032541.0546875,45603.405272258206
50588,10303,10303,36085023100,592842,0,Census Tract 231,New York,Richmond County,2052,3721,2163,2114,0,1740,312,62,49,49,0,40,9,0,1558,1327,0,1175,152,231,293,7.9,2.9,0.0,14.8,1030346.73828125,4109.88638542143
50589,10303,10303,36085023900,532083,0,Census Tract 239,New York,Richmond County,1561,2910,1761,1658,0,1520,41,97,103,103,0,61,42,0,1149,934,0,787,147,215,312,10.7,5.9,0.0,18.7,924740.453125,4515.2916145552
50590,10307,10307,36085024401,2102132,188204,Census Tract 244.01,New York,Richmond County,2431,4923,2685,2607,0,2193,238,176,78,62,0,62,0,16,2238,1920,0,1621,299,318,510,10.4,6.8,20.5,14.2,3651348.20703125,9848.38900095039
50590,10309,10309,36085024401,2102132,188204,Census Tract 244.01,New York,Richmond County,2431,4923,2685,2607,0,2193,238,176,78,62,0,62,0,16,2238,1920,0,1621,299,318,510,10.4,6.8,20.5,14.2,3651348.20703125,9848.38900095039
50591,10307,10307,36085024402,1823029,2075601,Census Tract 244.02,New York,Richmond County,2084,3592,2311,2108,0,2026,58,24,203,203,0,203,0,0,1281,1107,0,1096,11,174,198,5.5,1.1,0.0,13.6,3445973.01953125,9369.70290735508
50591,10309,10309,36085024402,1823029,2075601,Census Tract 244.02,New York,Richmond County,2084,3592,2311,2108,0,2026,58,24,203,203,0,203,0,0,1281,1107,0,1096,11,174,198,5.5,1.1,0.0,13.6,3445973.01953125,9369.70290735508
50592,10302,10302,36085024700,479856,0,Census Tract 247,New York,Richmond County,1235,2165,1422,1324,0,1151,84,89,98,98,0,98,0,0,743,597,0,514,83,146,235,10.9,6.7,0.0,19.7,833916.73828125,4323.16949756314
50592,10303,10303,36085024700,479856,0,Census Tract 247,New York,Richmond County,1235,2165,1422,1324,0,1151,84,89,98,98,0,98,0,0,743,597,0,514,83,146,235,10.9,6.7,0.0,19.7,833916.73828125,4323.16949756314
50593,10307,10307,36085024800,1649554,719369,Census Tract 248,New York,Richmond County,2029,3865,2166,2063,46,1940,43,34,103,103,0,103,0,0,1699,1629,23,1569,37,70,104,2.7,1.6,0.0,4.1,2961172.00390625,10783.003779923001
50593,10309,10309,36085024800,1649554,719369,Census Tract 248,New York,Richmond County,2029,3865,2166,2063,46,1940,43,34,103,103,0,103,0,0,1699,1629,23,1569,37,70,104,2.7,1.6,0.0,4.1,2961172.00390625,10783.003779923001
50594,10302,10302,36085025100,1171739,0,Census Tract 251,New York,Richmond County,3096,5551,3204,3096,0,3062,34,0,108,76,14,62,0,32,2347,2198,14,2127,57,149,181,3.3,0.0,29.6,6.3,2035730.97265625,6795.944387054599
50594,10314,10314,36085025100,1171739,0,Census Tract 251,New York,Richmond County,3096,5551,3204,3096,0,3062,34,0,108,76,14,62,0,32,2347,2198,14,2127,57,149,181,3.3,0.0,29.6,6.3,2035730.97265625,6795.944387054599
50595,10314,10314,36085027301,3037120,2518,Census Tract 273.01,New York,Richmond County,1657,3185,1805,1726,0,1614,43,69,79,79,0,79,0,0,1380,1137,0,1066,71,243,312,9.8,4.0,0.0,17.6,5278079.23828125,9249.090935772121
50596,10314,10314,36085027302,1021147,0,Census Tract 273.02,New York,Richmond County,1570,2646,1619,1576,0,1340,230,6,43,43,0,31,12,0,1027,949,0,895,54,78,84,3.2,0.4,0.0,7.6,1772920.4296875,6166.22271445603
50597,10314,10314,36085027702,1455129,0,Census Tract 277.02,New York,Richmond County,3285,5618,3430,3297,0,2999,286,12,133,133,0,120,13,0,2188,1970,57,1846,67,218,230,4.1,0.4,0.0,10.0,2525243.125,7140.48278947384
50598,10314,10314,36085027704,528028,0,Census Tract 277.04,New York,Richmond County,2139,3725,2315,2162,0,2009,130,23,153,153,0,145,8,0,1410,1274,0,1179,95,136,159,4.3,1.1,0.0,9.6,916485.7421875,4022.69706162904
50599,10314,10314,36085027705,531531,0,Census Tract 277.05,New York,Richmond County,2493,4836,2691,2555,34,2310,149,62,136,136,0,136,0,0,2145,1969,68,1819,82,176,238,4.9,2.4,0.0,8.2,922645.9921875,3974.42185171546
50600,10314,10314,36085027706,438638,0,Census Tract 277.06,New York,Richmond County,1424,2742,1573,1508,0,1337,87,84,65,65,0,65,0,0,1169,1017,0,926,91,152,236,8.6,5.6,0.0,13.0,761457.87109375,3775.9613221080604
50601,10306,10306,36085027900,5243635,177359,Census Tract 279,New York,Richmond County,821,1474,867,826,0,782,39,5,41,29,5,24,0,12,607,552,12,526,14,55,72,4.9,0.6,29.3,9.1,9192933.56640625,21763.1704913375
50601,10312,10312,36085027900,5243635,177359,Census Tract 279,New York,Richmond County,821,1474,867,826,0,782,39,5,41,29,5,24,0,12,607,552,12,526,14,55,72,4.9,0.6,29.3,9.1,9192933.56640625,21763.1704913375
50602,10303,10303,36085029102,9241350,1628913,Census Tract 291.02,New York,Richmond County,1304,2294,1335,1315,0,1268,36,11,20,20,0,20,0,0,959,888,0,860,28,71,82,3.6,0.8,0.0,7.4,16383117.035156302,42555.2739728737
50602,10314,10314,36085029102,9241350,1628913,Census Tract 291.02,New York,Richmond County,1304,2294,1335,1315,0,1268,36,11,20,20,0,20,0,0,959,888,0,860,28,71,82,3.6,0.8,0.0,7.4,16383117.035156302,42555.2739728737
50603,10311,10314,36085029103,2038798,533,Census Tract 291.03,New York,Richmond County,4172,6904,4476,4228,0,4047,125,56,248,248,0,229,19,0,2428,2238,11,2187,40,190,246,3.6,1.3,0.0,7.8,3541607.6875,10164.4361604617
50603,10314,10314,36085029103,2038798,533,Census Tract 291.03,New York,Richmond County,4172,6904,4476,4228,0,4047,125,56,248,248,0,229,19,0,2428,2238,11,2187,40,190,246,3.6,1.3,0.0,7.8,3541607.6875,10164.4361604617
50604,10314,10314,36085029104,1541564,0,Census Tract 291.04,New York,Richmond County,3046,5838,3369,3153,0,2997,49,107,216,216,0,216,0,0,2469,2370,0,2234,136,99,206,3.5,3.4,0.0,4.0,2677914.62890625,7874.354261241991
50605,10303,10303,36085030301,719281,0,Census Tract 303.01,New York,Richmond County,2446,4303,2630,2475,0,2411,35,29,155,145,0,145,0,10,1673,1550,0,1405,145,123,162,3.8,1.2,6.5,7.4,1249682.91796875,7418.7771806787
50605,10314,10314,36085030301,719281,0,Census Tract 303.01,New York,Richmond County,2446,4303,2630,2475,0,2411,35,29,155,145,0,145,0,10,1673,1550,0,1405,145,123,162,3.8,1.2,6.5,7.4,1249682.91796875,7418.7771806787
50606,10303,10303,36085030302,908763,0,Census Tract 303.02,New York,Richmond County,2763,4852,2961,2838,0,2622,141,75,123,123,0,123,0,0,1891,1827,0,1459,368,64,139,2.9,2.6,0.0,3.4,1579107.44140625,5586.83535765948
50606,10314,10314,36085030302,908763,0,Census Tract 303.02,New York,Richmond County,2763,4852,2961,2838,0,2622,141,75,123,123,0,123,0,0,1891,1827,0,1459,368,64,139,2.9,2.6,0.0,3.4,1579107.44140625,5586.83535765948
50607,10303,10303,36085031901,388050,0,Census Tract 319.01,New York,Richmond County,582,2107,818,747,0,422,160,165,71,71,0,58,13,0,1289,833,0,541,292,456,621,29.5,22.1,0.0,35.4,674428.32421875,3339.65394965312
50608,10303,10303,36085031902,690539,296692,Census Tract 319.02,New York,Richmond County,1761,3698,1943,1871,11,1616,134,110,72,56,0,45,11,16,1755,1102,13,994,95,653,779,21.1,5.9,22.2,37.2,1201249.0546875,6299.65266723375
50609,10303,10303,36085032300,3869216,462391,Census Tract 323,New York,Richmond County,510,939,527,517,0,466,44,7,10,10,0,10,0,0,412,352,0,337,15,60,67,7.1,1.4,0.0,14.6,6759215.1953125,13975.172715505
